阿巴嘎旗	a ba ga qi	1
阿坝县	a ba xian	1
阿坝藏族羌族自治州	a ba zang zu qiang zu zi zhi zhou	1
阿城市	a cheng shi	1
阿尔山市	a er shan shi	1
阿合奇县	a he qi xian	1
阿克塞哈萨克族自治县	a ke sai ha sa ke zu zi zhi xian	1
阿克苏市	a ke su shi	1
阿克陶县	a ke tao xian	1
阿拉尔市	a la er shi	1
阿拉善盟	a la shan meng	1
阿拉善右旗	a la shan you qi	1
阿拉善左旗	a la shan zuo qi	1
阿勒泰市	a le tai shi	1
阿鲁科尔沁旗	a lu ke er qin qi	1
阿荣旗	a rong qi	1
阿图什市	a tu shi shi	1
阿瓦提县	a wa ti xian	1
安波沙洲	an bo sha zhou	1
安达市	an da shi	1
安多县	an duo xian	1
安福县	an fu xian	1
安国市	an guo shi	1
安化县	an hua xian	1
安徽	an hui	1
安徽省	an hui sheng	1
安吉县	an ji xian	1
安康市	an kang shi	1
安龙县	an long xian	1
安陆市	an lu shi	1
安宁市	an ning shi	1
安平县	an ping xian	1
安庆市	an qing shi	1
安丘市	an qiu shi	1
安仁县	an ren xian	1
安塞县	an sai xian	1
鞍山市	an shan shi	1
安顺市	an shun shi	1
安图县	an tu xian	1
安西县	an xi xian	1
安溪县	an xi xian	1
安县	an xian	1
安乡县	an xiang xian	1
安新县	an xin xian	1
安阳市	an yang shi	1
安阳县	an yang xian	1
安义县	an yi xian	1
安远县	an yuan xian	1
安岳县	an yue xian	1
安泽县	an ze xian	1
昂仁县	ang ren xian	1
敖汉旗	ao han qi	1
澳门	ao men	1
澳门特别行政区	ao men te bie xing zheng qu	1
巴楚县	ba chu xian	1
巴东县	ba dong xian	1
巴里坤哈萨克自治县	ba li kun ha sa ke zi zhi xian	1
巴林右旗	ba lin you qi	1
巴林左旗	ba lin zuo qi	1
巴马瑶族自治县	ba ma yao zu zi zhi xian	1
巴南区	ba nan qu	1
巴青县	ba qing xian	1
八宿县	ba su xian	1
巴塘县	ba tang xian	1
巴彦淖尔市	ba yan nao er shi	1
巴彦县	ba yan xian	1
巴中市	ba zhong shi	1
霸州市	ba zhou shi	1
白城市	bai cheng shi	1
拜城县	bai cheng xian	1
白河县	bai he xian	1
柏礁	bai jiao	1
白朗县	bai lang xian	1
拜泉县	bai quan xian	1
百色市	bai se shi	1
白沙黎族自治县	bai sha li zu zi zhi xian	1
白山市	bai shan shi	1
白水县	bai shui xian	1
柏乡县	bai xiang xian	1
白银市	bai yin shi	1
白玉县	bai yu xian	1
班戈县	ban ge xian	1
班玛县	ban ma xian	1
板桥市	ban qiao shi	1
保德县	bao de xian	1
宝坻区	bao di qu	1
保定市	bao ding shi	1
宝丰县	bao feng xian	1
宝鸡市	bao ji shi	1
保靖县	bao jing xian	1
保康县	bao kang xian	1
宝清县	bao qing xian	1
宝山区	bao shan qu	1
保山市	bao shan shi	1
保亭黎族苗族自治县	bao ting li zu miao zu zi zhi xian	1
包头市	bao tou shi	1
宝兴县	bao xing xian	1
宝应县	bao ying xian	1
北安市	bei an shi	1
北碚区	bei bei qu	1
北辰区	bei chen qu	1
北川羌族自治县	bei chuan qiang zu zi zhi xian	1
北海市	bei hai shi	1
北京	bei jing	1
北康暗沙	bei kang an sha	1
北流市	bei liu shi	1
北宁市	bei ning shi	1
北票市	bei piao shi	1
北区	bei qu	1
北子岛	bei zi dao	1
本溪满族自治县	ben xi man zu zi zhi xian	1
本溪市	ben xi shi	1
蚌埠市	beng bu shi	1
毕节市	bi jie shi	1
比如县	bi ru xian	1
璧山县	bi shan xian	1
毕生礁	bi sheng jiao	1
泌阳县	bi yang xian	1
边坝县	bian ba xian	1
宾川县	bin chuan xian	1
滨海县	bin hai xian	1
宾县	bin xian	1
彬县	bin xian	1
宾阳县	bin yang xian	1
滨州市	bin zhou shi	1
博爱县	bo ai xian	1
博白县	bo bai xian	1
博湖县	bo hu xian	1
簸箕礁	bo ji jiao	1
舶兰礁	bo lan jiao	1
博乐市	bo le shi	1
勃利县	bo li xian	1
博罗县	bo luo xian	1
波密县	bo mi xian	1
泊头市	bo tou shi	1
博兴县	bo xing xian	1
博野县	bo ye xian	1
亳州市	bo zhou shi	1
布尔津县	bu er jin xian	1
布拖县	bu tuo xian	1
苍南县	cang nan xian	1
苍山县	cang shan xian	1
苍梧县	cang wu xian	1
苍溪县	cang xi xian	1
沧县	cang xian	1
沧源佤族自治县	cang yuan wa zu zi zhi xian	1
沧州市	cang zhou shi	1
曹县	cao xian	1
册亨县	ce heng xian	1
策勒县	ce le xian	1
岑巩县	cen gong xian	1
岑溪市	cen xi shi	1
察布查尔锡伯自治县	cha bu cha er xi bo zi zhi xian	1
察哈尔右翼后旗	cha ha er you yi hou qi	1
察哈尔右翼前旗	cha ha er you yi qian qi	1
察哈尔右翼中旗	cha ha er you yi zhong qi	1
茶陵县	cha ling xian	1
察雅县	cha ya xian	1
察隅县	cha yu xian	1
长白朝鲜族自治县	chang bai chao xian zu zi zhi xian	1
长春市	chang chun shi	1
长岛县	chang dao xian	1
常德市	chang de shi	1
昌都县	chang du xian	1
长丰县	chang feng xian	1
长葛市	chang ge shi	1
长海县	chang hai xian	1
昌吉市	chang ji shi	1
昌江黎族自治县	chang jiang li zu zi zhi xian	1
长乐市	chang le shi	1
昌乐县	chang le xian	1
昌黎县	chang li xian	1
长岭县	chang ling xian	1
长宁区	chang ning qu	1
常宁市	chang ning shi	1
长宁县	chang ning xian	1
昌宁县	chang ning xian	1
昌平区	chang ping qu	1
长沙市	chang sha shi	1
长沙县	chang sha xian	1
常山县	chang shan xian	1
长寿区	chang shou qu	1
常熟市	chang shu shi	1
长顺县	chang shun xian	1
长泰县	chang tai xian	1
长汀县	chang ting xian	1
昌图县	chang tu xian	1
长武县	chang wu xian	1
长兴县	chang xing xian	1
长阳土家族自治县	chang yang tu jia zu zi zhi xian	1
昌邑市	chang yi shi	1
长垣县	chang yuan xian	1
长治市	chang zhi shi	1
长治县	chang zhi xian	1
常州市	chang zhou shi	1
潮安县	chao an xian	1
巢湖市	chao hu shi	1
朝阳区	chao yang qu	1
朝阳市	chao yang shi	1
朝阳县	chao yang xian	1
潮州市	chao zhou shi	1
陈巴尔虎旗	chen ba er hu qi	1
辰溪县	chen xi xian	1
郴州市	chen zhou shi	1
成安县	cheng an xian	1
城步苗族自治县	cheng bu miao zu zi zhi xian	1
澄城县	cheng cheng xian	1
承德市	cheng de shi	1
承德县	cheng de xian	1
成都市	cheng du shi	1
称多县	cheng duo xian	1
呈贡县	cheng gong xian	1
城固县	cheng gu xian	1
澄江县	cheng jiang xian	1
城口县	cheng kou xian	1
澄迈县	cheng mai xian	1
成武县	cheng wu xian	1
成县	cheng xian	1
赤壁市	chi bi shi	1
赤城县	chi cheng xian	1
赤峰市	chi feng shi	1
茌平县	chi ping xian	1
赤水市	chi shui shi	1
池州市	chi zhou shi	1
崇礼县	chong li xian	1
崇明县浦东新区	chong ming xian pu dong xin qu	1
重庆	chong qing	1
重庆市	chong qing shi	1
崇仁县	chong ren xian	1
崇文区	chong wen qu	1
崇信县	chong xin xian	1
崇阳县	chong yang xian	1
崇义县	chong yi xian	1
崇州市	chong zhou shi	1
崇左市	chong zuo shi	1
楚雄市	chu xiong shi	1
滁州市	chu zhou shi	1
淳安县	chun an xian	1
淳化县	chun hua xian	1
慈利县	ci li xian	1
慈溪市	ci xi shi	1
磁县	ci xian	1
从化市	cong hua shi	1
从江县	cong jiang xian	1
措美县	cuo mei xian	1
错那县	cuo na xian	1
措勤县	cuo qin xian	1
大安市	da an shi	1
大埔区	da bu qu	1
大埔县	da bu xian	1
大厂回族自治县	da chang hui zu zi zhi xian	1
大城县	da cheng xian	1
大渡口区	da du kou qu	1
达尔罕茂明安联合旗	da er han mao ming an lian he qi	1
大方县	da fang xian	1
大丰市	da feng shi	1
大港区	da gang qu	1
大关县	da guan xian	1
大化瑶族自治县	da hua yao zu zi zhi xian	1
达拉特旗	da la te qi	1
大理市	da li shi	1
大荔县	da li xian	1
大连市	da lian shi	1
大名县	da ming xian	1
大宁县	da ning xian	1
大庆市	da qing shi	1
达日县	da ri xian	1
大石桥市	da shi qiao shi	1
大田县	da tian xian	1
大通回族土族自治县	da tong hui zu tu zu zi zhi xian	1
大同市	da tong shi	1
大同县	da tong xian	1
大洼县	da wa xian	1
大悟县	da wu xian	1
达县	da xian	1
大现礁	da xian jiao	1
大新县	da xin xian	1
大兴区	da xing qu	1
大姚县	da yao xian	1
大冶市	da ye shi	1
大邑县	da yi xian	1
大英县	da ying xian	1
大余县	da yu xian	1
达州市	da zhou shi	1
大竹县	da zhu xian	1
达孜县	da zi xian	1
大足县	da zu xian	1
岱山县	dai shan xian	1
代县	dai xian	1
丹巴县	dan ba xian	1
郸城县	dan cheng xian	1
丹东市	dan dong shi	1
丹凤县	dan feng xian	1
丹江口市	dan jiang kou shi	1
丹棱县	dan ling xian	1
弹丸礁	dan wan jiao	1
丹阳市	dan yang shi	1
丹寨县	dan zhai xian	1
儋州市	dan zhou shi	1
砀山县	dang shan xian	1
当涂县	dang tu xian	1
当雄县	dang xiong xian	1
当阳市	dang yang shi	1
稻城县	dao cheng xian	1
道孚县	dao fu xian	1
道县	dao xian	1
道真仡佬族苗族自治县	dao zhen ge lao zu miao zu zi zhi xian	1
德安县	de an xian	1
德保县	de bao xian	1
德昌县	de chang xian	1
德格县	de ge xian	1
德化县	de hua xian	1
德惠市	de hui shi	1
德江县	de jiang xian	1
德令哈市	de ling ha shi	1
德钦县	de qin xian	1
德庆县	de qing xian	1
德清县	de qing xian	1
得荣县	de rong xian	1
德兴市	de xing shi	1
德阳市	de yang shi	1
德州市	de zhou shi	1
登封市	deng feng shi	1
磴口县	deng kou xian	1
灯塔市	deng ta shi	1
邓州市	deng zhou shi	1
电白县	dian bai xian	1
垫江县	dian jiang xian	1
调兵山市	diao bing shan shi	1
钓鱼岛	diao yu dao	1
迭部县	die bu xian	1
定安县	ding an xian	1
定边县	ding bian xian	1
定结县	ding jie xian	1
定南县	ding nan xian	1
丁青县	ding qing xian	1
定日县	ding ri xian	1
定陶县	ding tao xian	1
定西市	ding xi shi	1
定襄县	ding xiang xian	1
定兴县	ding xing xian	1
定远县	ding yuan xian	1
定州市	ding zhou shi	1
东安县	dong an xian	1
东城区	dong cheng qu	1
东阿县	dong e xian	1
东方市	dong fang shi	1
东丰县	dong feng xian	1
东港市	dong gang shi	1
东莞市	dong guan shi	1
东光县	dong guang xian	1
东海县	dong hai xian	1
东礁	dong jiao	1
洞口县	dong kou xian	1
东兰县	dong lan xian	1
东丽区	dong li qu	1
东辽县	dong liao xian	1
东明县	dong ming xian	1
东宁县	dong ning xian	1
东平县	dong ping xian	1
东区	dong qu	1
东山县	dong shan xian	1
东台市	dong tai shi	1
洞头县	dong tou xian	1
东乌珠穆沁旗	dong wu zhu mu qin qi	1
东乡县	dong xiang xian	1
东乡族自治县	dong xiang zu zi zhi xian	1
东兴市	dong xing shi	1
东阳市	dong yang shi	1
东源县	dong yuan xian	1
东至县	dong zhi xian	1
都安瑶族自治县	dou an yao zu zi zhi xian	1
斗六市	dou liu shi	1
都昌县	du chang xian	1
杜尔伯特蒙古族自治县	du er bo te meng gu zu zi zhi xian	1
都江堰市	du jiang yan shi	1
都兰县	du lan xian	1
独山县	du shan xian	1
都匀市	du yun shi	1
堆龙德庆县	dui long de qing xian	1
敦化市	dun hua shi	1
敦煌市	dun huang shi	1
敦谦沙洲	dun qian sha zhou	1
多伦县	duo lun xian	1
峨边彝族自治县	e bian yi zu zi zhi xian	1
鄂尔多斯市	e er duo si shi	1
额尔古纳市	e er gu na shi	1
额济纳旗	e ji na qi	1
鄂伦春自治旗	e lun chun zi zhi qi	1
峨眉山市	e mei shan shi	1
额敏县	e min xian	1
峨山彝族自治县	e shan yi zu zi zhi xian	1
鄂托克旗	e tuo ke qi	1
鄂托克前旗	e tuo ke qian qi	1
鄂温克族自治旗	e wen ke zu zi zhi qi	1
鄂州市	e zhou shi	1
恩平市	en ping shi	1
恩施市	en shi shi	1
二连浩特市	er lian hao te shi	1
洱源县	er yuan xian	1
法库县	fa ku xian	1
繁昌县	fan chang xian	1
繁峙县	fan shi xian	1
范县	fan xian	1
防城港市	fang cheng gang shi	1
方城县	fang cheng xian	1
房山区	fang shan qu	1
方山县	fang shan xian	1
房县	fang xian	1
方正县	fang zheng xian	1
肥城市	fei cheng shi	1
肥东县	fei dong xian	1
肥西县	fei xi xian	1
费县	fei xian	1
肥乡县	fei xiang xian	1
费信岛	fei xin dao	1
汾西县	fen xi xian	1
汾阳市	fen yang shi	1
分宜县	fen yi xian	1
丰城市	feng cheng shi	1
凤城市	feng cheng shi	1
丰都县	feng du xian	1
凤冈县	feng gang xian	1
奉化市	feng hua shi	1
凤凰县	feng huang xian	1
奉节县	feng jie xian	1
封开县	feng kai xian	1
丰宁满族自治县	feng ning man zu zi zhi xian	1
凤庆县	feng qing xian	1
封丘县	feng qiu xian	1
凤山市	feng shan shi	1
凤山县	feng shan xian	1
丰顺县	feng shun xian	1
丰台区	feng tai qu	1
凤台县	feng tai xian	1
丰县	feng xian	1
凤县	feng xian	1
奉贤区	feng xian qu	1
凤翔县	feng xiang xian	1
奉新县	feng xin xian	1
凤阳县	feng yang xian	1
丰原市	feng yuan shi	1
丰镇市	feng zhen shi	1
佛冈县	fo gang xian	1
佛坪县	fo ping xian	1
佛山市	fo shan shi	1
福安市	fu an shi	1
阜城县	fu cheng xian	1
富川瑶族自治县	fu chuan yao zu zi zhi xian	1
福鼎市	fu ding shi	1
扶风县	fu feng xian	1
福贡县	fu gong xian	1
扶沟县	fu gou xian	1
府谷县	fu gu xian	1
福海县	fu hai xian	1
福建	fu jian	1
福建省	fu jian sheng	1
富锦市	fu jin shi	1
阜康市	fu kang shi	1
浮梁县	fu liang xian	1
涪陵区	fu ling qu	1
富民县	fu min xian	1
阜南县	fu nan xian	1
阜宁县	fu ning xian	1
富宁县	fu ning xian	1
抚宁县	fu ning xian	1
阜平县	fu ping xian	1
富平县	fu ping xian	1
福清市	fu qing shi	1
福泉市	fu quan shi	1
浮山县	fu shan xian	1
抚顺市	fu shun shi	1
富顺县	fu shun xian	1
抚顺县	fu shun xian	1
抚松县	fu song xian	1
扶绥县	fu sui xian	1
富县	fu xian	1
阜新蒙古族自治县	fu xin meng gu zu zi zhi xian	1
阜新市	fu xin shi	1
阜阳市	fu yang shi	1
富阳市	fu yang shi	1
富裕县	fu yu xian	1
扶余县	fu yu xian	1
富源县	fu yuan xian	1
抚远县	fu yuan xian	1
富蕴县	fu yun xian	1
抚州市	fu zhou shi	1
福州市	fu zhou shi	1
噶尔县	ga er xian	1
改则县	gai ze xian	1
盖州市	gai zhou shi	1
甘德县	gan de xian	1
甘谷县	gan gu xian	1
甘洛县	gan luo xian	1
甘南县	gan nan xian	1
甘泉县	gan quan xian	1
甘肃	gan su	1
甘肃省	gan su sheng	1
赣县	gan xian	1
赣榆县	gan yu xian	1
赣州市	gan zhou shi	1
甘孜县	gan zi xian	1
甘孜藏族自治州	gan zi zang zu zi zhi zhou	1
岗巴县	gang ba xian	1
刚察县	gang cha xian	1
高安市	gao an shi	1
高碑店市	gao bei dian shi	1
藁城市	gao cheng shi	1
高淳县	gao chun xian	1
皋兰县	gao lan xian	1
高陵县	gao ling xian	1
高密市	gao mi shi	1
高平市	gao ping shi	1
高青县	gao qing xian	1
高台县	gao tai xian	1
高唐县	gao tang xian	1
高县	gao xian	1
高雄市	gao xiong shi	1
高雄县	gao xiong xian	1
高阳县	gao yang xian	1
高要市	gao yao shi	1
高邑县	gao yi xian	1
高邮市	gao you shi	1
高州市	gao zhou shi	1
格尔木市	ge er mu shi	1
革吉县	ge ji xian	1
个旧市	ge jiu shi	1
根河市	gen he shi	1
耿马傣族佤族自治县	geng ma dai zu wa zu zi zhi xian	1
公安县	gong an xian	1
工布江达县	gong bu jiang da xian	1
恭城瑶族自治县	gong cheng yao zu zi zhi xian	1
贡嘎县	gong ga xian	1
共和县	gong he xian	1
贡觉县	gong jue xian	1
巩留县	gong liu xian	1
贡山独龙族怒族自治县	gong shan du long zu nu zu zi zhi xian	1
珙县	gong xian	1
巩义市	gong yi shi	1
公主岭市	gong zhu ling shi	1
固安县	gu an xian	1
谷城县	gu cheng xian	1
故城县	gu cheng xian	1
古交市	gu jiao shi	1
古浪县	gu lang xian	1
古蔺县	gu lin xian	1
固始县	gu shi xian	1
古田县	gu tian xian	1
古县	gu xian	1
固阳县	gu yang xian	1
固原市	gu yuan shi	1
沽源县	gu yuan xian	1
古丈县	gu zhang xian	1
固镇县	gu zhen xian	1
关岭布依族苗族自治县铜仁市	guan ling bu yi zu miao zu zi zhi xian tong ren shi	1
灌南县	guan nan xian	1
观塘区	guan tang qu	1
馆陶县	guan tao xian	1
冠县	guan xian	1
灌阳县	guan yang xian	1
灌云县	guan yun xian	1
广安市	guang an shi	1
广昌县	guang chang xian	1
广德县	guang de xian	1
广东	guang dong	1
广东省	guang dong sheng	1
广丰县	guang feng xian	1
广汉市	guang han shi	1
广河县	guang he xian	1
广灵县	guang ling xian	1
广南县	guang nan xian	1
广宁县	guang ning xian	1
广平县	guang ping xian	1
广饶县	guang rao xian	1
光山县	guang shan xian	1
广水市	guang shui shi	1
广西	guang xi	1
广西壮族自治区	guang xi zhuang zu zi zhi qu	1
光星礁	guang xing jiao	1
光星仔礁	guang xing zai jiao	1
广雅滩	guang ya tan	1
广元市	guang yuan shi	1
光泽县	guang ze xian	1
广州市	guang zhou shi	1
广宗县	guang zong xian	1
贵德县	gui de xian	1
贵定县	gui ding xian	1
桂东县	gui dong xian	1
贵港市	gui gang shi	1
鬼喊礁	gui han jiao	1
桂林市	gui lin shi	1
贵南县	gui nan xian	1
桂平市	gui ping shi	1
贵溪市	gui xi shi	1
贵阳市	gui yang shi	1
桂阳县	gui yang xian	1
贵州	gui zhou	1
贵州省	gui zhou sheng	1
涡阳县	guo yang xian	1
哈巴河县	ha ba he xian	1
哈尔滨市	ha er bin shi	1
哈密市	ha mi shi	1
海安县	hai an xian	1
海城市	hai cheng shi	1
海淀区	hai dian qu	1
海丰县	hai feng xian	1
海口市	hai kou shi	1
海林市	hai lin shi	1
海伦市	hai lun shi	1
海门市	hai men shi	1
海南	hai nan	1
海南省	hai nan sheng	1
海宁市	hai ning shi	1
海兴县	hai xing xian	1
海晏县	hai yan xian	1
海盐县	hai yan xian	1
海阳市	hai yang shi	1
海原县	hai yuan xian	1
韩城市	han cheng shi	1
汉川市	han chuan shi	1
邯郸市	han dan shi	1
邯郸县	han dan xian	1
汉沽区	han gu qu	1
含山县	han shan xian	1
汉寿县	han shou xian	1
汉阴县	han yin xian	1
汉源县	han yuan xian	1
汉中市	han zhong shi	1
杭锦后旗	hang jin hou qi	1
杭锦旗	hang jin qi	1
杭州市	hang zhou shi	1
河北	he bei	1
河北区	he bei qu	1
河北省	he bei sheng	1
鹤壁市	he bi shi	1
和布克赛尔蒙古自治县	he bu ke sai er meng gu zi zhi xian	1
河池市	he chi shi	1
合川市	he chuan shi	1
河东区	he dong qu	1
合肥市	he fei shi	1
鹤峰县	he feng xian	1
鹤岗市	he gang shi	1
河间市	he jian shi	1
合江县	he jiang xian	1
河津市	he jin shi	1
和静县	he jing xian	1
河口瑶族自治县	he kou yao zu zi zhi xian	1
贺兰县	he lan xian	1
和林格尔县	he lin ge er xian	1
和龙市	he long shi	1
河南	he nan	1
河南蒙古族自治县	he nan meng gu zu zi zhi xian	1
河南省	he nan sheng	1
和平区	he ping qu	1
和平县	he ping xian	1
合浦县	he pu xian	1
鹤庆县	he qing xian	1
河曲县	he qu xian	1
鹤山市	he shan shi	1
合山市	he shan shi	1
合水县	he shui xian	1
和顺县	he shun xian	1
和硕县	he shuo xian	1
和田市	he tian shi	1
和田县	he tian xian	1
河西区	he xi qu	1
和县	he xian	1
合阳县	he yang xian	1
河源市	he yuan shi	1
菏泽市	he ze shi	1
赫章县	he zhang xian	1
和政县	he zheng xian	1
贺州市	he zhou shi	1
合作市	he zuo shi	1
黑河市	hei he shi	1
黑龙江	hei long jiang	1
黑龙江省	hei long jiang sheng	1
黑山县	hei shan xian	1
黑水县	hei shui xian	1
黑瞎子岛	hei xia zi dao	1
衡东县	heng dong xian	1
横峰县	heng feng xian	1
衡南县	heng nan xian	1
衡山县	heng shan xian	1
横山县	heng shan xian	1
衡水市	heng shui shi	1
横县	heng xian	1
衡阳市	heng yang shi	1
衡阳县	heng yang xian	1
红安县	hong an xian	1
红河县	hong he xian	1
洪湖市	hong hu shi	1
洪江市	hong jiang shi	1
虹口区	hong kou qu	1
红桥区	hong qiao qu	1
洪洞县	hong tong xian	1
鸿庥岛	hong xiu dao	1
洪雅县	hong ya xian	1
红原县	hong yuan xian	1
洪泽县	hong ze xian	1
侯马市	hou ma shi	1
湖北	hu bei	1
湖北省	hu bei sheng	1
壶关县	hu guan xian	1
呼和浩特市	hu he hao te shi	1
湖口县	hu kou xian	1
虎林市	hu lin shi	1
葫芦岛市	hu lu dao shi	1
呼伦贝尔市	hu lun bei er shi	1
呼玛县	hu ma xian	1
湖南	hu nan	1
湖南省	hu nan sheng	1
呼图壁县	hu tu bi xian	1
户县	hu xian	1
湖州市	hu zhou shi	1
互助土族自治县	hu zhu tu zu zi zhi xian	1
华安县	hua an xian	1
华池县	hua chi xian	1
桦川县	hua chuan xian	1
化德县	hua de xian	1
桦甸市	hua dian shi	1
花莲市	hua lian shi	1
花莲县	hua lian xian	1
化隆回族自治县	hua long hui zu zi zhi xian	1
桦南县	hua nan xian	1
华宁县	hua ning xian	1
华坪县	hua ping xian	1
华容县	hua rong xian	1
华亭县	hua ting xian	1
华县	hua xian	1
滑县	hua xian	1
华阴市	hua yin shi	1
华蓥市	hua ying shi	1
花垣县	hua yuan xian	1
化州市	hua zhou shi	1
淮安市	huai an shi	1
怀安县	huai an xian	1
淮北市	huai bei shi	1
淮滨县	huai bin xian	1
怀化市	huai hua shi	1
怀集县	huai ji xian	1
怀来县	huai lai xian	1
淮南市	huai nan shi	1
怀宁县	huai ning xian	1
怀仁县	huai ren xian	1
怀柔区	huai rou qu	1
淮阳县	huai yang xian	1
怀远县	huai yuan xian	1
环江毛南族自治县	huan jiang mao nan zu zi zhi xian	1
桓仁满族自治县	huan ren man zu zi zhi xian	1
桓台县	huan tai xian	1
环县	huan xian	1
潢川县	huang chuan xian	1
黄大仙区	huang da xian qu	1
黄冈市	huang gang shi	1
黄骅市	huang hua shi	1
黄陵县	huang ling xian	1
黄龙县	huang long xian	1
黄梅县	huang mei xian	1
黄平县	huang ping xian	1
黄浦区	huang pu qu	1
黄山市	huang shan shi	1
黄石市	huang shi shi	1
湟源县	huang yuan xian	1
湟中县	huang zhong xian	1
惠安县	hui an xian	1
会昌县	hui chang xian	1
会东县	hui dong xian	1
惠东县	hui dong xian	1
惠来县	hui lai xian	1
会理县	hui li xian	1
惠民县	hui min xian	1
辉南县	hui nan xian	1
会宁县	hui ning xian	1
惠水县	hui shui xian	1
会同县	hui tong xian	1
徽县	hui xian	1
辉县市	hui xian shi	1
会泽县	hui ze xian	1
惠州市	hui zhou shi	1
珲春市	hun chun shi	1
浑源县	hun yuan xian	1
霍城县	huo cheng xian	1
获嘉县	huo jia xian	1
霍林郭勒市	huo lin guo le shi	1
霍邱县	huo qiu xian	1
霍山县	huo shan xian	1
霍州市	huo zhou shi	1
集安市	ji an shi	1
吉安市	ji an shi	1
吉安县	ji an xian	1
鸡东县	ji dong xian	1
吉林	ji lin	1
吉林省	ji lin sheng	1
吉林市	ji lin shi	1
基隆市	ji long shi	1
吉隆县	ji long xian	1
即墨市	ji mo shi	1
吉木乃县	ji mu nai xian	1
吉木萨尔县	ji mu sa er xian	1
济南市	ji nan shi	1
济宁市	ji ning shi	1
稷山县	ji shan xian	1
吉首市	ji shou shi	1
吉水县	ji shui xian	1
鸡西市	ji xi shi	1
绩溪县	ji xi xian	1
蓟县	ji xian	1
吉县	ji xian	1
集贤县	ji xian xian	1
济阳县	ji yang xian	1
济源市	ji yuan shi	1
鸡泽县	ji ze xian	1
冀州市	ji zhou shi	1
加查县	jia cha xian	1
嘉定区	jia ding qu	1
嘉禾县	jia he xian	1
夹江县	jia jiang xian	1
嘉黎县	jia li xian	1
佳木斯市	jia mu si shi	1
嘉善县	jia shan xian	1
伽师县	jia shi xian	1
郏县	jia xian	1
佳县	jia xian	1
嘉祥县	jia xiang xian	1
嘉兴市	jia xing shi	1
嘉义市	jia yi shi	1
嘉义县	jia yi xian	1
嘉荫县	jia yin xian	1
嘉峪关市	jia yu guan shi	1
嘉鱼县	jia yu xian	1
建昌县	jian chang xian	1
剑川县	jian chuan xian	1
建德市	jian de shi	1
剑阁县	jian ge xian	1
剑河县	jian he xian	1
建湖县	jian hu xian	1
监利县	jian li xian	1
建宁县	jian ning xian	1
建瓯市	jian ou shi	1
建平县	jian ping xian	1
建始县	jian shi xian	1
建水县	jian shui xian	1
建阳市	jian yang shi	1
简阳市	jian yang shi	1
尖扎县	jian zha xian	1
江安县	jiang an xian	1
江北区	jiang bei qu	1
江城哈尼族彝族自治县	jiang cheng ha ni zu yi zu zi zhi xian	1
江川县	jiang chuan xian	1
江达县	jiang da xian	1
江都市	jiang du shi	1
江华瑶族自治县	jiang hua yao zu zi zhi xian	1
江津市	jiang jin shi	1
江口县	jiang kou xian	1
将乐县	jiang le xian	1
江陵县	jiang ling xian	1
江门市	jiang men shi	1
江山市	jiang shan shi	1
江苏	jiang su	1
江苏省	jiang su sheng	1
江西	jiang xi	1
江西省	jiang xi sheng	1
绛县	jiang xian	1
姜堰市	jiang yan shi	1
江阴市	jiang yin shi	1
江永县	jiang yong xian	1
江油市	jiang you shi	1
江源县	jiang yuan xian	1
江孜县	jiang zi xian	1
交城县	jiao cheng xian	1
蛟河市	jiao he shi	1
交口县	jiao kou xian	1
蕉岭县	jiao ling xian	1
胶南市	jiao nan shi	1
胶州市	jiao zhou shi	1
焦作市	jiao zuo shi	1
揭东县	jie dong xian	1
界首市	jie shou shi	1
揭西县	jie xi xian	1
介休市	jie xiu shi	1
揭阳市	jie yang shi	1
金昌市	jin chang shi	1
晋城市	jin cheng shi	1
金川县	jin chuan xian	1
金湖县	jin hu xian	1
金华市	jin hua shi	1
晋江市	jin jiang shi	1
金门县	jin men xian	1
津南区	jin nan qu	1
晋宁县	jin ning xian	1
金平苗族瑶族傣族自治县	jin ping miao zu yao zu dai zu zi zhi xian	1
锦屏县	jin ping xian	1
金沙县	jin sha xian	1
金山区	jin shan qu	1
津市市	jin shi shi	1
金塔县	jin ta xian	1
金坛市	jin tan shi	1
金堂县	jin tang xian	1
金溪县	jin xi xian	1
进贤县	jin xian xian	1
金乡县	jin xiang xian	1
金秀瑶族自治县	jin xiu yao zu zi zhi xian	1
金阳县	jin yang xian	1
缙云县	jin yun xian	1
金寨县	jin zhai xian	1
晋中市	jin zhong shi	1
锦州市	jin zhou shi	1
晋州市	jin zhou shi	1
静安区	jing an qu	1
靖安县	jing an xian	1
靖边县	jing bian xian	1
泾川县	jing chuan xian	1
旌德县	jing de xian	1
景德镇市	jing de zhen shi	1
景东彝族自治县	jing dong yi zu zi zhi xian	1
井冈山市	jing gang shan shi	1
景谷彝族傣族自治县	jing gu yi zu dai zu zi zhi xian	1
静海县	jing hai xian	1
精河县	jing he xian	1
景宏岛	jing hong dao	1
景洪市	jing hong shi	1
靖江市	jing jiang shi	1
静乐县	jing le xian	1
荆门市	jing men shi	1
景宁畲族自治县	jing ning she zu zi zhi xian	1
静宁县	jing ning xian	1
京山县	jing shan xian	1
景泰县	jing tai xian	1
靖西县	jing xi xian	1
景县	jing xian	1
泾县	jing xian	1
井陉县	jing xing xian	1
井研县	jing yan xian	1
泾阳县	jing yang xian	1
靖宇县	jing yu xian	1
靖远县	jing yuan xian	1
泾源县	jing yuan xian	1
靖州苗族侗族自治县	jing zhou miao zu dong zu zi zhi xian	1
荆州市	jing zhou shi	1
九江市	jiu jiang shi	1
九江县	jiu jiang xian	1
九龙城区	jiu long cheng qu	1
九龙坡区	jiu long po qu	1
九龙县	jiu long xian	1
酒泉市	jiu quan shi	1
九台市	jiu tai shi	1
九寨沟县	jiu zhai gou xian	1
久治县	jiu zhi xian	1
巨鹿县	ju lu xian	1
莒南县	ju nan xian	1
句容市	ju rong shi	1
莒县	ju xian	1
巨野县	ju ye xian	1
鄄城县	juan cheng xian	1
筠连县	jun lian xian	1
喀喇沁旗	ka la qin qi	1
喀喇沁左翼蒙古族自治县	ka la qin zuo yi meng gu zu zi zhi xian	1
喀什市	ka shi shi	1
开封市	kai feng shi	1
开封县	kai feng xian	1
开化县	kai hua xian	1
开江县	kai jiang xian	1
凯里市	kai li shi	1
开鲁县	kai lu xian	1
开平市	kai ping shi	1
开县	kai xian	1
开阳县	kai yang xian	1
开远市	kai yuan shi	1
开原市	kai yuan shi	1
康保县	kang bao xian	1
康定县	kang ding xian	1
康乐县	kang le xian	1
康马县	kang ma xian	1
康平县	kang ping xian	1
康县	kang xian	1
克东县	ke dong xian	1
科尔沁右翼前旗	ke er qin you yi qian qi	1
科尔沁右翼中旗	ke er qin you yi zhong qi	1
科尔沁左翼后旗	ke er qin zuo yi hou qi	1
科尔沁左翼中旗	ke er qin zuo yi zhong qi	1
克拉玛依市	ke la ma yi shi	1
岢岚县	ke lan xian	1
柯坪县	ke ping xian	1
克山县	ke shan xian	1
克什克腾旗	ke shi ke teng qi	1
垦利县	ken li xian	1
库车县	ku che xian	1
库尔勒市	ku er le shi	1
库伦旗	ku lun qi	1
宽城满族自治县	kuan cheng man zu zi zhi xian	1
宽甸满族自治县	kuan dian man zu zi zhi xian	1
葵青区	kui qing qu	1
奎屯市	kui tun shi	1
昆明市	kun ming shi	1
昆山市	kun shan shi	1
拉萨市	la sa shi	1
拉孜县	la zi xian	1
来安县	lai an xian	1
来宾市	lai bin shi	1
来凤县	lai feng xian	1
涞水县	lai shui xian	1
莱芜市	lai wu shi	1
莱西市	lai xi shi	1
莱阳市	lai yang shi	1
涞源县	lai yuan xian	1
莱州市	lai zhou shi	1
澜沧拉祜族自治县	lan cang la hu zu zi zhi xian	1
岚皋县	lan gao xian	1
兰考县	lan kao xian	1
兰坪白族普米族自治县	lan ping bai zu pu mi zu zi zhi xian	1
蓝山县	lan shan xian	1
蓝田县	lan tian xian	1
兰溪市	lan xi shi	1
兰西县	lan xi xian	1
岚县	lan xian	1
兰州市	lan zhou shi	1
廊坊市	lang fang shi	1
浪卡子县	lang ka zi xian	1
郎溪县	lang xi xian	1
朗县	lang xian	1
阆中市	lang zhong shi	1
老河口市	lao he kou shi	1
乐亭县	lao ting xian	1
乐安县	le an xian	1
乐昌市	le chang shi	1
乐东黎族自治县	le dong li zu zi zhi xian	1
乐都县	le du xian	1
乐陵市	le ling shi	1
乐平市	le ping shi	1
乐山市	le shan shi	1
乐业县	le ye xian	1
乐至县	le zhi xian	1
雷波县	lei bo xian	1
雷山县	lei shan xian	1
类乌齐县	lei wu qi xian	1
耒阳市	lei yang shi	1
雷州市	lei zhou shi	1
冷水江市	leng shui jiang shi	1
荔波县	li bo xian	1
黎城县	li cheng xian	1
利川市	li chuan shi	1
黎川县	li chuan xian	1
离岛区	li dao qu	1
丽江市	li jiang shi	1
利津县	li jin xian	1
醴陵市	li ling shi	1
黎平县	li ping xian	1
荔浦县	li pu xian	1
礼泉县	li quan xian	1
梨树县	li shu xian	1
丽水市	li shui shi	1
溧水县	li shui xian	1
理塘县	li tang xian	1
蠡县	li xian	1
澧县	li xian	1
理县	li xian	1
礼县	li xian	1
利辛县	li xin xian	1
溧阳市	li yang shi	1
连城县	lian cheng xian	1
莲花县	lian hua xian	1
廉江市	lian jiang shi	1
连江县	lian jiang xian	1
连南瑶族自治县	lian nan yao zu zi zhi xian	1
连平县	lian ping xian	1
连山壮族瑶族自治县	lian shan zhuang zu yao zu zi zhi xian	1
涟水县	lian shui xian	1
涟源市	lian yuan shi	1
连云港市	lian yun gang shi	1
连州市	lian zhou shi	1
凉城县	liang cheng xian	1
两当县	liang dang xian	1
梁河县	liang he xian	1
梁平县	liang ping xian	1
梁山县	liang shan xian	1
凉山彝族自治州	liang shan yi zu zi zhi zhou	1
聊城市	liao cheng shi	1
辽宁	liao ning	1
辽阳市	liao yang shi	1
辽阳县	liao yang xian	1
辽源市	liao yuan shi	1
辽中县	liao zhong xian	1
临安市	lin an shi	1
临沧市	lin cang shi	1
临城县	lin cheng xian	1
林甸县	lin dian xian	1
临汾市	lin fen shi	1
临高县	lin gao xian	1
临桂县	lin gui xian	1
临海市	lin hai shi	1
临江市	lin jiang shi	1
林口县	lin kou xian	1
临澧县	lin li xian	1
临清市	lin qing shi	1
临朐县	lin qu xian	1
临泉县	lin quan xian	1
临沭县	lin shu xian	1
邻水县	lin shui xian	1
临潭县	lin tan xian	1
临洮县	lin tao xian	1
临武县	lin wu xian	1
临西县	lin xi xian	1
林西县	lin xi xian	1
临夏市	lin xia shi	1
临夏县	lin xia xian	1
临县	lin xian	1
临湘市	lin xiang shi	1
临沂市	lin yi shi	1
临邑县	lin yi xian	1
临猗县	lin yi xian	1
临颍县	lin ying xian	1
麟游县	lin you xian	1
临泽县	lin ze xian	1
临漳县	lin zhang xian	1
林芝县	lin zhi xian	1
林州市	lin zhou shi	1
林周县	lin zhou xian	1
灵宝市	ling bao shi	1
灵璧县	ling bi xian	1
陵川县	ling chuan xian	1
灵川县	ling chuan xian	1
凌海市	ling hai shi	1
灵丘县	ling qiu xian	1
灵山县	ling shan xian	1
灵石县	ling shi xian	1
灵寿县	ling shou xian	1
陵水黎族自治县	ling shui li zu zi zhi xian	1
灵台县	ling tai xian	1
灵武市	ling wu shi	1
陵县	ling xian	1
凌源市	ling yuan shi	1
凌云县	ling yun xian	1
六安市	liu an shi	1
留坝县	liu ba xian	1
柳河县	liu he xian	1
柳江县	liu jiang xian	1
柳林县	liu lin xian	1
六门礁	liu men jiao	1
六盘水市	liu pan shui shi	1
浏阳市	liu yang shi	1
六枝特区	liu zhi te qu	1
柳州市	liu zhou shi	1
隆安县	long an xian	1
隆昌县	long chang xian	1
陇川县	long chuan xian	1
龙川县	long chuan xian	1
隆德县	long de xian	1
龙海市	long hai shi	1
隆化县	long hua xian	1
隆回县	long hui xian	1
龙江县	long jiang xian	1
龙井市	long jing shi	1
龙口市	long kou shi	1
龙里县	long li xian	1
隆林各族自治县	long lin ge zu zi zhi xian	1
龙陵县	long ling xian	1
龙门县	long men xian	1
陇南市	long nan shi	1
龙南县	long nan xian	1
龙泉市	long quan shi	1
龙山县	long shan xian	1
龙胜各族自治县	long sheng ge zu zi zhi xian	1
陇西县	long xi xian	1
陇县	long xian	1
龙岩市	long yan shi	1
隆尧县	long yao xian	1
龙游县	long you xian	1
龙州县	long zhou xian	1
隆子县	long zi xian	1
娄底市	lou di shi	1
娄烦县	lou fan xian	1
潞城市	lu cheng shi	1
陆川县	lu chuan xian	1
鲁甸县	lu dian xian	1
泸定县	lu ding xian	1
陆丰市	lu feng shi	1
禄丰县	lu feng xian	1
陆河县	lu he xian	1
炉霍县	lu huo xian	1
庐江县	lu jiang xian	1
陆良县	lu liang xian	1
卢龙县	lu long xian	1
碌曲县	lu qu xian	1
鹿泉市	lu quan shi	1
禄劝彝族苗族自治县	lu quan yi zu miao zu zi zhi xian	1
芦山县	lu shan xian	1
鲁山县	lu shan xian	1
卢氏县	lu shi xian	1
泸水县	lu shui xian	1
卢湾区	lu wan qu	1
潞西市	lu xi shi	1
芦溪县	lu xi xian	1
泸西县	lu xi xian	1
泸溪县	lu xi xian	1
泸县	lu xian	1
鹿邑县	lu yi xian	1
泸州市	lu zhou shi	1
栾城县	luan cheng xian	1
栾川县	luan chuan xian	1
滦南县	luan nan xian	1
滦平县	luan ping xian	1
滦县	luan xian	1
略阳县	lue yang xian	1
轮台县	lun tai xian	1
萝北县	luo bei xian	1
罗城仫佬族自治县	luo cheng mu lao zu zi zhi xian	1
洛川县	luo chuan xian	1
罗甸县	luo dian xian	1
罗定市	luo ding shi	1
漯河市	luo he shi	1
罗江县	luo jiang xian	1
洛隆县	luo long xian	1
洛南县	luo nan xian	1
洛宁县	luo ning xian	1
罗平县	luo ping xian	1
洛浦县	luo pu xian	1
罗山县	luo shan xian	1
罗田县	luo tian xian	1
洛阳市	luo yang shi	1
罗源县	luo yuan xian	1
洛扎县	luo zha xian	1
绿春县	lv chun xian	1
吕梁市	lv liang shi	1
马鞍山市	ma an shan shi	1
马边彝族自治县	ma bian yi zu zi zhi xian	1
麻城市	ma cheng shi	1
玛多县	ma duo xian	1
马尔康县	ma er kang xian	1
马公市	ma gong shi	1
马关县	ma guan xian	1
马欢岛	ma huan dao	1
麻江县	ma jiang xian	1
麻栗坡县	ma li po xian	1
马龙县	ma long xian	1
玛纳斯县	ma na si xian	1
玛沁县	ma qin xian	1
玛曲县	ma qu xian	1
马山县	ma shan xian	1
麻阳苗族自治县	ma yang miao zu zi zhi xian	1
麦盖提县	mai gai ti xian	1
满城县	man cheng xian	1
满洲里市	man zhou li shi	1
芒康县	mang kang xian	1
茂名市	mao ming shi	1
茂县	mao xian	1
美姑县	mei gu xian	1
梅河口市	mei he kou shi	1
眉山市	mei shan shi	1
湄潭县	mei tan xian	1
梅县	mei xian	1
眉县	mei xian	1
梅州市	mei zhou shi	1
门头沟区	men tou gou qu	1
门源回族自治县	men yuan hui zu zi zhi xian	1
蒙城县	meng cheng xian	1
孟村回族自治县	meng cun hui zu zi zhi xian	1
勐海县	meng hai xian	1
孟津县	meng jin xian	1
孟连傣族拉祜族佤族自治县	meng lian dai zu la hu zu wa zu zi zhi xian	1
蒙山县	meng shan xian	1
蒙阴县	meng yin xian	1
孟州市	meng zhou shi	1
蒙自县	meng zi xian	1
弥渡县	mi du xian	1
弥勒县	mi le xian	1
米林县	mi lin xian	1
汨罗市	mi luo shi	1
米泉市	mi quan shi	1
密山市	mi shan shi	1
米易县	mi yi xian	1
密云县	mi yun xian	1
米脂县	mi zhi xian	1
渑池县	mian chi xian	1
冕宁县	mian ning xian	1
勉县	mian xian	1
绵阳市	mian yang shi	1
绵竹市	mian zhu shi	1
苗栗市	miao li shi	1
苗栗县	miao li xian	1
民丰县	min feng xian	1
闵行区	min hang qu	1
民和回族土族自治县	min he hui zu tu zu zi zhi xian	1
闽侯县	min hou xian	1
民乐县	min le xian	1
民勤县	min qin xian	1
闽清县	min qing xian	1
民权县	min quan xian	1
岷县	min xian	1
明光市	ming guang shi	1
名山县	ming shan xian	1
明水县	ming shui xian	1
明溪县	ming xi xian	1
漠河县	mo he xian	1
墨江哈尼族自治县	mo jiang ha ni zu zi zhi xian	1
莫力达瓦达斡尔族自治旗	mo li da wa da wo er zu zi zhi qi	1
墨脱县	mo tuo xian	1
墨玉县	mo yu xian	1
墨竹工卡县	mo zhu gong ka xian	1
牟定县	mou ding xian	1
沐川县	mu chuan xian	1
牡丹江市	mu dan jiang shi	1
木兰县	mu lan xian	1
木垒哈萨克自治县	mu lei ha sa ke zi zhi xian	1
木里藏族自治县	mu li zang zu zi zhi xian	1
穆棱市	mu ling shi	1
那坡县	na po xian	1
那曲县	na qu xian	1
纳雍县	na yong xian	1
乃东县	nai dong xian	1
奈罗礁	nai luo jiao	1
奈曼旗	nai man qi	1
南岸区	nan an qu	1
南安市	nan an shi	1
南澳县	nan ao xian	1
南部县	nan bu xian	1
南昌市	nan chang shi	1
南昌县	nan chang xian	1
南城县	nan cheng xian	1
南充市	nan chong shi	1
南川市	nan chuan shi	1
南丹县	nan dan xian	1
南丰县	nan feng xian	1
南宫市	nan gong shi	1
南海礁	nan hai jiao	1
南和县	nan he xian	1
南华礁	nan hua jiao	1
南华县	nan hua xian	1
南汇区	nan hui qu	1
南涧彝族自治县	nan jian yi zu zi zhi xian	1
南江县	nan jiang xian	1
南京市	nan jing shi	1
南靖县	nan jing xian	1
南开区	nan kai qu	1
南康暗沙	nan kang an sha	1
南康市	nan kang shi	1
南乐县	nan le xian	1
南陵县	nan ling xian	1
南木林县	nan mu lin xian	1
南宁市	nan ning shi	1
南皮县	nan pi xian	1
南平市	nan ping shi	1
南区	nan qu	1
南沙群岛	nan sha qun dao	1
南通礁	nan tong jiao	1
南通市	nan tong shi	1
南投市	nan tou shi	1
南投县	nan tou xian	1
南威岛	nan wei dao	1
南溪县	nan xi xian	1
南县	nan xian	1
南雄市	nan xiong shi	1
南阳市	nan yang shi	1
南钥岛	nan yao dao	1
南漳县	nan zhang xian	1
南召县	nan zhao xian	1
南郑县	nan zheng xian	1
南子岛	nan zi dao	1
囊谦县	nang qian xian	1
讷河市	ne he shi	1
内黄县	nei huang xian	1
内江市	nei jiang shi	1
内蒙古	nei meng gu	1
内丘县	nei qiu xian	1
内乡县	nei xiang xian	1
嫩江县	nen jiang xian	1
尼勒克县	ni le ke xian	1
尼玛县	ni ma xian	1
尼木县	ni mu xian	1
聂拉木县	nie la mu xian	1
聂荣县	nie rong xian	1
宁安市	ning an shi	1
宁波市	ning bo shi	1
宁城县	ning cheng xian	1
宁德市	ning de shi	1
宁都县	ning du xian	1
宁国市	ning guo shi	1
宁海县	ning hai xian	1
宁河县	ning he xian	1
宁化县	ning hua xian	1
宁晋县	ning jin xian	1
宁津县	ning jin xian	1
宁蒗彝族自治县	ning lang yi zu zi zhi xian	1
宁陵县	ning ling xian	1
宁明县	ning ming xian	1
宁南县	ning nan xian	1
宁强县	ning qiang xian	1
宁陕县	ning shan xian	1
宁武县	ning wu xian	1
宁夏	ning xia	1
宁夏回族自治区	ning xia hui zu zi zhi qu	1
宁县	ning xian	1
宁乡县	ning xiang xian	1
宁阳县	ning yang xian	1
宁远县	ning yuan xian	1
农安县	nong an xian	1
磐安县	pan an xian	1
盘锦市	pan jin shi	1
盘山县	pan shan xian	1
磐石市	pan shi shi	1
盘县	pan xian	1
攀枝花市	pan zhi hua shi	1
沛县	pei xian	1
蓬安县	peng an xian	1
蓬勃堡	peng bo bao	1
澎湖县	peng hu xian	1
蓬莱市	peng lai shi	1
彭山县	peng shan xian	1
彭水苗族土家族自治县	peng shui miao zu tu jia zu zi zhi xian	1
蓬溪县	peng xi xian	1
彭阳县	peng yang xian	1
彭泽县	peng ze xian	1
彭州市	peng zhou shi	1
皮山县	pi shan xian	1
郫县	pi xian	1
邳州市	pi zhou shi	1
偏关县	pian guan xian	1
平安县	ping an xian	1
屏边苗族自治县	ping bian miao zu zi zhi xian	1
平昌县	ping chang xian	1
平顶山市	ping ding shan shi	1
平定县	ping ding xian	1
屏东市	ping dong shi	1
屏东县	ping dong xian	1
平度市	ping du shi	1
平谷区	ping gu qu	1
平果县	ping guo xian	1
平和县	ping he xian	1
平湖市	ping hu shi	1
平江县	ping jiang xian	1
平乐县	ping le xian	1
平利县	ping li xian	1
平凉市	ping liang shi	1
平陆县	ping lu xian	1
平罗县	ping luo xian	1
屏南县	ping nan xian	1
平南县	ping nan xian	1
平泉县	ping quan xian	1
屏山县	ping shan xian	1
平山县	ping shan xian	1
平顺县	ping shun xian	1
平潭县	ping tan xian	1
平塘县	ping tang xian	1
平武县	ping wu xian	1
萍乡市	ping xiang shi	1
凭祥市	ping xiang shi	1
平乡县	ping xiang xian	1
平阳县	ping yang xian	1
平遥县	ping yao xian	1
平邑县	ping yi xian	1
平阴县	ping yin xian	1
平舆县	ping yu xian	1
平远县	ping yuan xian	1
平原县	ping yuan xian	1
鄱阳县	po yang xian	1
普安县	pu an xian	1
浦北县	pu bei xian	1
蒲城县	pu cheng xian	1
浦城县	pu cheng xian	1
普定县	pu ding xian	1
普洱哈尼族彝族自治县	pu er ha ni zu yi zu zi zhi xian	1
普格县	pu ge xian	1
蒲江县	pu jiang xian	1
浦江县	pu jiang xian	1
普兰店市	pu lan dian shi	1
普兰县	pu lan xian	1
普宁市	pu ning shi	1
莆田市	pu tian shi	1
普陀区	pu tuo qu	1
蒲县	pu xian	1
濮阳市	pu yang shi	1
濮阳县	pu yang xian	1
蕲春县	qi chun xian	1
启东市	qi dong shi	1
祁东县	qi dong xian	1
齐河县	qi he xian	1
綦江县	qi jiang xian	1
祁连县	qi lian xian	1
祁门县	qi men xian	1
齐齐哈尔市	qi qi ha er shi	1
岐山县	qi shan xian	1
七台河市	qi tai he shi	1
奇台县	qi tai xian	1
栖霞市	qi xia shi	1
杞县	qi xian	1
淇县	qi xian	1
祁县	qi xian	1
祁阳县	qi yang xian	1
迁安市	qian an shi	1
乾安县	qian an xian	1
黔东南苗族侗族自治州	qian dong nan miao zu dong zu zi zhi zhou	1
前郭尔罗斯蒙古族自治县	qian guo er luo si meng gu zu zi zhi xian	1
黔江区	qian jiang qu	1
潜江市	qian jiang shi	1
黔南布依族苗族自治州	qian nan bu yi zu miao zu zi zhi zhou	1
铅山县	qian shan xian	1
潜山县	qian shan xian	1
犍为县	qian wei xian	1
黔西南布依族苗族自治州	qian xi nan bu yi zu miao zu zi zhi zhou	1
迁西县	qian xi xian	1
黔西县	qian xi xian	1
乾县	qian xian	1
千阳县	qian yang xian	1
巧家县	qiao jia xian	1
且末县	qie mo xian	1
秦安县	qin an xian	1
秦皇岛市	qin huang dao shi	1
沁水县	qin shui xian	1
沁县	qin xian	1
沁阳市	qin yang shi	1
沁源县	qin yuan xian	1
钦州市	qin zhou shi	1
庆安县	qing an xian	1
庆城县	qing cheng xian	1
青川县	qing chuan xian	1
青岛市	qing dao shi	1
清丰县	qing feng xian	1
青冈县	qing gang xian	1
青海	qing hai	1
青海省	qing hai sheng	1
青河县	qing he xian	1
清河县	qing he xian	1
清涧县	qing jian xian	1
清流县	qing liu xian	1
青龙满族自治县	qing long man zu zi zhi xian	1
晴隆县	qing long xian	1
青浦区	qing pu qu	1
青神县	qing shen xian	1
清水河县	qing shui he xian	1
清水县	qing shui xian	1
青田县	qing tian xian	1
青铜峡市	qing tong xia shi	1
青县	qing xian	1
清新县	qing xin xian	1
清徐县	qing xu xian	1
庆阳市	qing yang shi	1
青阳县	qing yang xian	1
清原满族自治县	qing yuan man zu zi zhi xian	1
清远市	qing yuan shi	1
庆元县	qing yuan xian	1
清苑县	qing yuan xian	1
庆云县	qing yun xian	1
清镇市	qing zhen shi	1
青州市	qing zhou shi	1
琼海市	qiong hai shi	1
琼礁	qiong jiao	1
琼结县	qiong jie xian	1
邛崃市	qiong lai shi	1
琼中黎族苗族自治县	qiong zhong li zu miao zu zi zhi xian	1
丘北县	qiu bei xian	1
邱县	qiu xian	1
曲阜市	qu fu shi	1
曲靖市	qu jing shi	1
曲麻莱县	qu ma lai xian	1
曲水县	qu shui xian	1
曲松县	qu song xian	1
曲沃县	qu wo xian	1
渠县	qu xian	1
曲阳县	qu yang xian	1
衢州市	qu zhou shi	1
曲周县	qu zhou xian	1
全椒县	quan jiao xian	1
全南县	quan nan xian	1
荃湾区	quan wan qu	1
泉州市	quan zhou shi	1
全州县	quan zhou xian	1
确山县	que shan xian	1
染青沙洲	ran qing sha zhou	1
壤塘县	rang tang xian	1
饶河县	rao he xian	1
饶平县	rao ping xian	1
饶阳县	rao yang xian	1
仁布县	ren bu xian	1
仁化县	ren hua xian	1
仁怀市	ren huai shi	1
任丘市	ren qiu shi	1
仁寿县	ren shou xian	1
任县	ren xian	1
日积礁	ri ji jiao	1
日喀则市	ri ka ze shi	1
日土县	ri tu xian	1
日照市	ri zhao shi	1
荣昌县	rong chang xian	1
荣成市	rong cheng shi	1
容城县	rong cheng xian	1
榕江县	rong jiang xian	1
融水苗族自治县	rong shui miao zu zi zhi xian	1
荣县	rong xian	1
容县	rong xian	1
汝城县	ru cheng xian	1
如东县	ru dong xian	1
如皋市	ru gao shi	1
汝南县	ru nan xian	1
乳山市	ru shan shi	1
汝阳县	ru yang xian	1
乳源瑶族自治县	ru yuan yao zu zi zhi xian	1
汝州市	ru zhou shi	1
瑞安市	rui an shi	1
瑞昌市	rui chang shi	1
芮城县	rui cheng xian	1
瑞金市	rui jin shi	1
瑞丽市	rui li shi	1
若尔盖县	ruo er gai xian	1
若羌县	ruo qiang xian	1
萨嘎县	sa ga xian	1
萨迦县	sa jia xian	1
三都水族自治县	san du shui zu zi zhi xian	1
三河市	san he shi	1
三江侗族自治县	san jiang dong zu zi zhi xian	1
三门峡市	san men xia shi	1
三门县	san men xian	1
三明市	san ming shi	1
三穗县	san sui xian	1
三台县	san tai xian	1
三亚市	san ya shi	1
三原县	san yuan xian	1
桑日县	sang ri xian	1
桑植县	sang zhi xian	1
色达县	se da xian	1
莎车县	sha che xian	1
沙河市	sha he shi	1
沙坪坝区	sha ping ba qu	1
沙田区	sha tian qu	1
沙湾县	sha wan xian	1
沙县	sha xian	1
沙雅县	sha ya xian	1
沙洋县	sha yang xian	1
山丹县	shan dan xian	1
山东	shan dong	1
山东省	shan dong sheng	1
鄯善县	shan shan xian	1
汕头市	shan tou shi	1
汕尾市	shan wei shi	1
陕西	shan xi	1
山西	shan xi	1
陕西省	shan xi sheng	1
山西省	shan xi sheng	1
陕县	shan xian	1
单县	shan xian	1
山阳县	shan yang xian	1
山阴县	shan yin xian	1
上蔡县	shang cai xian	1
商城县	shang cheng xian	1
商都县	shang du xian	1
上高县	shang gao xian	1
上海	shang hai	1
上海市	shang hai shi	1
上杭县	shang hang xian	1
商河县	shang he xian	1
上栗县	shang li xian	1
上林县	shang lin xian	1
商洛市	shang luo shi	1
商南县	shang nan xian	1
商丘市	shang qiu shi	1
上饶市	shang rao shi	1
上饶县	shang rao xian	1
商水县	shang shui xian	1
上思县	shang si xian	1
尚义县	shang yi xian	1
上犹县	shang you xian	1
上虞市	shang yu shi	1
尚志市	shang zhi shi	1
邵东县	shao dong xian	1
韶关市	shao guan shi	1
韶山市	shao shan shi	1
邵武市	shao wu shi	1
绍兴市	shao xing shi	1
绍兴县	shao xing xian	1
邵阳市	shao yang shi	1
邵阳县	shao yang xian	1
射洪县	she hong xian	1
社旗县	she qi xian	1
歙县	she xian	1
涉县	she xian	1
射阳县	she yang xian	1
神池县	shen chi xian	1
神木县	shen mu xian	1
神农架林区	shen nong jia lin qu	1
沈丘县	shen qiu xian	1
深水埗区	shen shui bu qu	1
莘县	shen xian	1
沈阳市	shen yang shi	1
深泽县	shen ze xian	1
申扎县	shen zha xian	1
深圳市	shen zhen shi	1
深州市	shen zhou shi	1
嵊泗县	sheng si xian	1
嵊州市	sheng zhou shi	1
施秉县	shi bing xian	1
石城县	shi cheng xian	1
施甸县	shi dian xian	1
什邡市	shi fang shi	1
石河子市	shi he zi shi	1
石家庄市	shi jia zhuang shi	1
石景山区	shi jing shan qu	1
石林彝族自治县	shi lin yi zu zi zhi xian	1
石楼县	shi lou xian	1
石门县	shi men xian	1
石棉县	shi mian xian	1
石屏县	shi ping xian	1
石阡县	shi qian xian	1
石渠县	shi qu xian	1
石泉县	shi quan xian	1
石狮市	shi shi shi	1
石首市	shi shou shi	1
石台县	shi tai xian	1
始兴县	shi xing xian	1
十堰市	shi yan shi	1
石柱土家族自治县	shi zhu tu jia zu zi zhi xian	1
师宗县	shi zong xian	1
石嘴山市	shi zui shan shi	1
寿光市	shou guang shi	1
寿宁县	shou ning xian	1
寿县	shou xian	1
寿阳县	shou yang xian	1
舒城县	shu cheng xian	1
疏附县	shu fu xian	1
舒兰市	shu lan shi	1
疏勒县	shu le xian	1
沭阳县	shu yang xian	1
双柏县	shuang bai xian	1
双城市	shuang cheng shi	1
双峰县	shuang feng xian	1
双黄沙洲	shuang huang sha zhou	1
双辽市	shuang liao shi	1
双流县	shuang liu xian	1
双牌县	shuang pai xian	1
双桥区	shuang qiao qu	1
双鸭山市	shuang ya shan shi	1
水城县	shui cheng xian	1
水富县	shui fu xian	1
顺昌县	shun chang xian	1
顺平县	shun ping xian	1
顺义区	shun yi qu	1
朔州市	shuo zhou shi	1
四川	si chuan	1
四川省	si chuan sheng	1
泗洪县	si hong xian	1
四会市	si hui shi	1
司令礁	si ling jiao	1
思茅市	si mao shi	1
思南县	si nan xian	1
四平市	si ping shi	1
泗水县	si shui xian	1
泗县	si xian	1
泗阳县	si yang xian	1
四子王旗	si zi wang qi	1
松江区	song jiang qu	1
嵩明县	song ming xian	1
松潘县	song pan xian	1
松桃苗族自治县	song tao miao zu zi zhi xian	1
松溪县	song xi xian	1
嵩县	song xian	1
松阳县	song yang xian	1
松原市	song yuan shi	1
松滋市	song zi shi	1
肃北蒙古族自治县	su bei meng gu zu zi zhi xian	1
肃南裕固族自治县	su nan yu gu zu zi zhi xian	1
苏尼特右旗	su ni te you qi	1
苏尼特左旗	su ni te zuo qi	1
肃宁县	su ning xian	1
宿迁市	su qian shi	1
宿松县	su song xian	1
苏州市	su zhou shi	1
宿州市	su zhou shi	1
绥滨县	sui bin xian	1
遂昌县	sui chang xian	1
遂川县	sui chuan xian	1
绥德县	sui de xian	1
绥芬河市	sui fen he shi	1
绥化市	sui hua shi	1
绥江县	sui jiang xian	1
绥棱县	sui ling xian	1
遂宁市	sui ning shi	1
睢宁县	sui ning xian	1
绥宁县	sui ning xian	1
遂平县	sui ping xian	1
遂溪县	sui xi xian	1
濉溪县	sui xi xian	1
睢县	sui xian	1
绥阳县	sui yang xian	1
绥中县	sui zhong xian	1
随州市	sui zhou shi	1
孙吴县	sun wu xian	1
索县	suo xian	1
塔城市	ta cheng shi	1
塔河县	ta he xian	1
塔什库尔干塔吉克自治县	ta shen ku er gan ta ji ke zi zhi xian	1
泰安市	tai an shi	1
台安县	tai an xian	1
太白县	tai bai xian	1
太保市	tai bao shi	1
台北市	tai bei shi	1
台北县	tai bei xian	1
太仓市	tai cang shi	1
台东市	tai dong shi	1
台东县	tai dong xian	1
太谷县	tai gu xian	1
太和县	tai he xian	1
泰和县	tai he xian	1
太湖县	tai hu xian	1
台江县	tai jiang xian	1
太康县	tai kang xian	1
泰来县	tai lai xian	1
台南市	tai nan shi	1
台南县	tai nan xian	1
泰宁县	tai ning xian	1
太仆寺旗	tai pu si qi	1
台前县	tai qian xian	1
台山市	tai shan shi	1
泰顺县	tai shun xian	1
台湾	tai wan	1
台湾省	tai wan sheng	1
泰兴市	tai xing shi	1
太原市	tai yuan shi	1
台中市	tai zhong shi	1
台中县	tai zhong xian	1
台州市	tai zhou shi	1
泰州市	tai zhou shi	1
宕昌县	tan chang xian	1
郯城县	tan cheng xian	1
塘沽区	tang gu qu	1
唐海县	tang hai xian	1
唐河县	tang he xian	1
唐山市	tang shan shi	1
唐县	tang xian	1
汤阴县	tang yin xian	1
汤原县	tang yuan xian	1
桃江县	tao jiang xian	1
洮南市	tao nan shi	1
桃园市	tao yuan shi	1
桃园县	tao yuan xian	1
桃源县	tao yuan xian	1
特克斯县	te ke si xian	1
腾冲县	teng chong xian	1
藤县	teng xian	1
滕州市	teng zhou shi	1
天长市	tian chang shi	1
天等县	tian deng xian	1
田东县	tian dong xian	1
天峨县	tian e xian	1
天津	tian jin	1
天津市	tian jin shi	1
天峻县	tian jun xian	1
田林县	tian lin xian	1
天门市	tian men shi	1
天全县	tian quan xian	1
天水市	tian shui shi	1
天台县	tian tai xian	1
田阳县	tian yang xian	1
天镇县	tian zhen xian	1
天柱县	tian zhu xian	1
天祝藏族自治县	tian zhu zang zu zi zhi xian	1
铁力市	tie li shi	1
铁岭市	tie ling shi	1
铁岭县	tie ling xian	1
桐柏县	tong bai xian	1
桐城市	tong cheng shi	1
通城县	tong cheng xian	1
铜川市	tong chuan shi	1
通道侗族自治县	tong dao dong zu zi zhi xian	1
同德县	tong de xian	1
铜鼓县	tong gu xian	1
潼关县	tong guan xian	1
通海县	tong hai xian	1
通河县	tong he xian	1
通化市	tong hua shi	1
通化县	tong hua xian	1
同江市	tong jiang shi	1
通江县	tong jiang xian	1
铜梁县	tong liang xian	1
通辽市	tong liao shi	1
铜陵市	tong ling shi	1
桐庐县	tong lu xian	1
潼南县	tong nan xian	1
同仁县	tong ren xian	1
通山县	tong shan xian	1
铜山县	tong shan xian	1
通渭县	tong wei xian	1
桐乡市	tong xiang shi	1
同心县	tong xin xian	1
通许县	tong xu xian	1
通榆县	tong yu xian	1
通州区	tong zhou qu	1
通州市	tong zhou shi	1
桐梓县	tong zi xian	1
吐鲁番市	tu lu fan shi	1
图们市	tu men shi	1
土默特右旗	tu mo te you qi	1
土默特左旗	tu mo te zuo qi	1
图木舒克市	tu mu shu ke shi	1
突泉县	tu quan xian	1
团风县	tuan feng xian	1
屯昌县	tun chang xian	1
屯留县	tun liu xian	1
屯门区	tun men qu	1
托克托县	tuo ke tuo xian	1
托克逊县	tuo ke xun xian	1
托里县	tuo li xian	1
瓦房店市	wa fang dian shi	1
万安滩	wan an tan	1
万安县	wan an xian	1
万年县	wan nian xian	1
万宁市	wan ning shi	1
万全县	wan quan xian	1
万荣县	wan rong xian	1
万山特区	wan shan te qu	1
万盛区	wan sheng qu	1
万源市	wan yuan shi	1
湾仔区	wan zai qu	1
万载县	wan zai xian	1
万州区	wan zhou qu	1
旺苍县	wang cang xian	1
望城县	wang cheng xian	1
望都县	wang du xian	1
望江县	wang jiang xian	1
望奎县	wang kui xian	1
望谟县	wang mo xian	1
汪清县	wang qing xian	1
围场满族蒙古族自治县	wei chang man zu meng gu zu zi zhi xian	1
潍坊市	wei fang shi	1
威海市	wei hai shi	1
卫辉市	wei hui shi	1
渭南市	wei nan shi	1
威宁彝族回族苗族自治县	wei ning yi zu hui zu miao zu zi zhi xian	1
微山县	wei shan xian	1
巍山彝族回族自治县	wei shan yi zu hui zu zi zhi xian	1
尉氏县	wei shi xian	1
维西傈僳族自治县	wei xi li su zu zi zhi xian	1
魏县	wei xian	1
威县	wei xian	1
威信县	wei xin xian	1
威远县	wei yuan xian	1
渭源县	wei yuan xian	1
文安县	wen an xian	1
文昌市	wen chang shi	1
文成县	wen cheng xian	1
汶川县	wen chuan xian	1
文登市	wen deng shi	1
温泉县	wen quan xian	1
文山县	wen shan xian	1
汶上县	wen shang xian	1
文水县	wen shui xian	1
温宿县	wen su xian	1
闻喜县	wen xi xian	1
文县	wen xian	1
温县	wen xian	1
温州市	wen zhou shi	1
瓮安县	weng an xian	1
翁牛特旗	weng niu te qi	1
翁源县	weng yuan xian	1
武安市	wu an shi	1
吴堡县	wu bao xian	1
五常市	wu chang shi	1
武城县	wu cheng xian	1
务川仡佬族苗族自治县平坝县	wu chuan ge lao zu miao zu zi zhi xian ping ba xian	1
吴川市	wu chuan shi	1
武川县	wu chuan xian	1
五大连池市	wu da lian chi shi	1
无棣县	wu di xian	1
武定县	wu ding xian	1
五峰土家族自治县	wu feng tu jia zu zi zhi xian	1
舞钢市	wu gang shi	1
武冈市	wu gang shi	1
武功县	wu gong xian	1
乌海市	wu hai shi	1
武汉市	wu han shi	1
五河县	wu he xian	1
芜湖市	wu hu shi	1
芜湖县	wu hu xian	1
五华县	wu hua xian	1
无极县	wu ji xian	1
五家渠市	wu jia qu shi	1
吴江市	wu jiang shi	1
乌拉特后旗	wu la te hou qi	1
乌拉特前旗	wu la te qian qi	1
乌拉特中旗	wu la te zhong qi	1
乌兰察布市	wu lan cha bu shi	1
乌兰浩特市	wu lan hao te shi	1
乌兰县	wu lan xian	1
五莲县	wu lian xian	1
武隆县	wu long xian	1
乌鲁木齐市	wu lu mu qi shi	1
乌鲁木齐县	wu lu mu qi xian	1
无乜礁	wu mie jiao	1
武鸣县	wu ming xian	1
武宁县	wu ning xian	1
武平县	wu ping xian	1
吴旗县	wu qi xian	1
乌恰县	wu qia xian	1
武强县	wu qiang xian	1
吴桥县	wu qiao xian	1
武清区	wu qing qu	1
巫山县	wu shan xian	1
武山县	wu shan xian	1
乌审旗	wu shen qi	1
武胜县	wu sheng xian	1
乌什县	wu shi xian	1
乌苏市	wu su shi	1
五台县	wu tai xian	1
武威市	wu wei shi	1
无为县	wu wei xian	1
无锡市	wu xi shi	1
巫溪县	wu xi xian	1
武乡县	wu xiang xian	1
武宣县	wu xuan xian	1
武穴市	wu xue shi	1
舞阳县	wu yang xian	1
武夷山市	wu yi shan shi	1
武邑县	wu yi xian	1
武义县	wu yi xian	1
五原县	wu yuan xian	1
婺源县	wu yuan xian	1
五寨县	wu zhai xian	1
五指山市	wu zhi shan shi	1
武陟县	wu zhi xian	1
吴忠市	wu zhong shi	1
梧州市	wu zhou shi	1
西安市	xi an shi	1
西昌市	xi chang shi	1
西城区	xi cheng qu	1
西充县	xi chong xian	1
西畴县	xi chou xian	1
淅川县	xi chuan xian	1
喜德县	xi de xian	1
西丰县	xi feng xian	1
息烽县	xi feng xian	1
西贡区	xi gong qu	1
西和县	xi he xian	1
西华县	xi hua xian	1
西吉县	xi ji xian	1
西礁	xi jiao	1
锡林郭勒盟	xi lin guo le meng	1
锡林浩特市	xi lin hao te shi	1
西林县	xi lin xian	1
西盟佤族自治县	xi meng wa zu zi zhi xian	1
西宁市	xi ning shi	1
西平县	xi ping xian	1
西青区	xi qing qu	1
习水县	xi shui xian	1
浠水县	xi shui xian	1
西卫滩	xi wei tan	1
西乌珠穆沁旗	xi wu zhu mu qin qi	1
西峡县	xi xia xian	1
隰县	xi xian	1
息县	xi xian	1
西乡县	xi xiang xian	1
昔阳县	xi yang xian	1
西藏	xi zang	1
西藏自治区	xi zang zi zhi qu	1
夏河县	xia he xian	1
峡江县	xia jiang xian	1
夏津县	xia jin xian	1
厦门市	xia men shi	1
霞浦县	xia pu xian	1
夏县	xia xian	1
夏邑县	xia yi xian	1
咸丰县	xian feng xian	1
仙居县	xian ju xian	1
咸宁市	xian ning shi	1
仙桃市	xian tao shi	1
献县	xian xian	1
咸阳市	xian yang shi	1
仙游县	xian you xian	1
项城市	xiang cheng shi	1
襄城县	xiang cheng xian	1
乡城县	xiang cheng xian	1
襄樊市	xiang fan shi	1
襄汾县	xiang fen xian	1
香港	xiang gang	1
香港特别行政区	xiang gang te bie xing zheng qu	1
香格里拉县	xiang ge li la xian	1
香河县	xiang he xian	1
镶黄旗	xiang huang qi	1
乡宁县	xiang ning xian	1
象山县	xiang shan xian	1
响水县	xiang shui xian	1
湘潭市	xiang tan shi	1
湘潭县	xiang tan xian	1
湘西土家族苗族自治州	xiang xi tu jia zu miao zu zi zhi zhou	1
湘乡市	xiang xiang shi	1
湘阴县	xiang yin xian	1
襄垣县	xiang yuan xian	1
祥云县	xiang yun xian	1
象州县	xiang zhou xian	1
孝昌县	xiao chang xian	1
孝感市	xiao gan shi	1
小金县	xiao jin xian	1
萧县	xiao xian	1
孝义市	xiao yi shi	1
谢通门县	xie tong men xian	1
新安县	xin an xian	1
新巴尔虎右旗	xin ba er hu you qi	1
新巴尔虎左旗	xin ba er hu zuo qi	1
新宾满族自治县	xin bin man zu zi zhi xian	1
新蔡县	xin cai xian	1
新昌县	xin chang xian	1
忻城县	xin cheng xian	1
信丰县	xin feng xian	1
新丰县	xin feng xian	1
新干县	xin gan xian	1
新和县	xin he xian	1
新河县	xin he xian	1
新化县	xin hua xian	1
新晃侗族自治县	xin huang dong zu zi zhi xian	1
辛集市	xin ji shi	1
新建县	xin jian xian	1
新疆	xin jiang	1
新疆维吾尔自治区	xin jiang wei wu er zi zhi qu	1
新绛县	xin jiang xian	1
新津县	xin jin xian	1
新乐市	xin le shi	1
新龙县	xin long xian	1
新密市	xin mi shi	1
新民市	xin min shi	1
新宁县	xin ning xian	1
新平彝族傣族自治县	xin ping yi zu dai zu zi zhi xian	1
新邵县	xin shao xian	1
新泰市	xin tai shi	1
新田县	xin tian xian	1
新县	xin xian	1
新乡市	xin xiang shi	1
新乡县	xin xiang xian	1
新兴县	xin xing xian	1
信阳市	xin yang shi	1
新野县	xin ye xian	1
信宜市	xin yi shi	1
新沂市	xin yi shi	1
新营市	xin ying shi	1
新余市	xin yu shi	1
新源县	xin yuan xian	1
新郑市	xin zheng shi	1
忻州市	xin zhou shi	1
新竹市	xin zhu shi	1
新竹县	xin zhu xian	1
兴安盟	xing an meng	1
兴安县	xing an xian	1
兴城市	xing cheng shi	1
兴国县	xing guo xian	1
兴海县	xing hai xian	1
兴和县	xing he xian	1
兴化市	xing hua shi	1
兴隆县	xing long xian	1
兴宁市	xing ning shi	1
兴仁县	xing ren xian	1
兴山县	xing shan xian	1
邢台市	xing tai shi	1
邢台县	xing tai xian	1
行唐县	xing tang xian	1
兴文县	xing wen xian	1
兴县	xing xian	1
荥阳市	xing yang shi	1
兴业县	xing ye xian	1
兴义市	xing yi shi	1
星子县	xing zi xian	1
雄县	xiong xian	1
休宁县	xiu ning xian	1
秀山土家族苗族自治县	xiu shan tu jia zu miao zu zi zhi xian	1
修水县	xiu shui xian	1
修文县	xiu wen xian	1
修武县	xiu wu xian	1
岫岩满族自治县	xiu yan man zu zi zhi xian	1
许昌市	xu chang shi	1
许昌县	xu chang xian	1
徐汇区	xu hui qu	1
溆浦县	xu pu xian	1
徐水县	xu shui xian	1
徐闻县	xu wen xian	1
盱眙县	xu yi xian	1
叙永县	xu yong xian	1
徐州市	xu zhou shi	1
宣城市	xuan cheng shi	1
宣恩县	xuan en xian	1
宣汉县	xuan han xian	1
宣化县	xuan hua xian	1
宣威市	xuan wei shi	1
宣武区	xuan wu qu	1
寻甸回族自治县	xun dian hui zu zi zhi xian	1
循化撒拉族自治县	xun hua sa la zu zi zhi xian	1
逊克县	xun ke xian	1
寻乌县	xun wu xian	1
浚县	xun xian	1
旬阳县	xun yang xian	1
旬邑县	xun yi xian	1
雅安市	ya an shi	1
亚东县	ya dong xian	1
雅江县	ya jiang xian	1
牙克石市	ya ke shi shi	1
延安市	yan an shi	1
延边朝鲜族自治州	yan bian chao xian zu zi zhi zhou	1
盐边县	yan bian xian	1
延长县	yan chang xian	1
盐城市	yan cheng shi	1
盐池县	yan chi xian	1
延川县	yan chuan xian	1
沿河土家族自治县	yan he tu jia zu zi zhi xian	1
延吉市	yan ji shi	1
延津县	yan jin xian	1
盐津县	yan jin xian	1
鄢陵县	yan ling xian	1
炎陵县	yan ling xian	1
焉耆回族自治县	yan qi hui zu zi zhi xian	1
延庆县	yan qing xian	1
盐山县	yan shan xian	1
砚山县	yan shan xian	1
偃师市	yan shi shi	1
延寿县	yan shou xian	1
烟台市	yan tai shi	1
盐亭县	yan ting xian	1
盐源县	yan yuan xian	1
兖州市	yan zhou shi	1
漾濞彝族自治县	yang bi yi zu zi zhi xian	1
阳城县	yang cheng xian	1
阳春市	yang chun shi	1
阳东县	yang dong xian	1
阳高县	yang gao xian	1
阳谷县	yang gu xian	1
阳江市	yang jiang shi	1
杨浦区	yang pu qu	1
阳曲县	yang qu xian	1
阳泉市	yang quan shi	1
阳山县	yang shan xian	1
阳朔县	yang shuo xian	1
阳西县	yang xi xian	1
洋县	yang xian	1
阳信县	yang xin xian	1
阳新县	yang xin xian	1
阳原县	yang yuan xian	1
扬中市	yang zhong shi	1
扬州市	yang zhou shi	1
姚安县	yao an xian	1
叶城县	ye cheng xian	1
叶县	ye xian	1
依安县	yi an xian	1
宜宾市	yi bin shi	1
宜宾县	yi bin xian	1
宜昌市	yi chang shi	1
宜城市	yi cheng shi	1
翼城县	yi cheng xian	1
伊川县	yi chuan xian	1
宜川县	yi chuan xian	1
伊春市	yi chun shi	1
宜春市	yi chun shi	1
宜都市	yi du shi	1
宜丰县	yi feng xian	1
宜黄县	yi huang xian	1
伊金霍洛旗	yi jin huo luo qi	1
宜君县	yi jun xian	1
宜兰市	yi lan shi	1
依兰县	yi lan xian	1
宜兰县	yi lan xian	1
宜良县	yi liang xian	1
彝良县	yi liang xian	1
仪陇县	yi long xian	1
义马市	yi ma shi	1
易门县	yi men xian	1
沂南县	yi nan xian	1
伊宁市	yi ning shi	1
伊宁县	yi ning xian	1
沂水县	yi shui xian	1
伊通满族自治县	yi tong man zu zi zhi xian	1
义乌市	yi wu shi	1
伊吾县	yi wu xian	1
黟县	yi xian	1
义县	yi xian	1
易县	yi xian	1
宜兴市	yi xing shi	1
益阳市	yi yang shi	1
宜阳县	yi yang xian	1
弋阳县	yi yang xian	1
沂源县	yi yuan xian	1
宜章县	yi zhang xian	1
仪征市	yi zheng shi	1
宜州市	yi zhou shi	1
银川市	yin chuan shi	1
印江土家族苗族自治县	yin jiang tu jia zu miao zu zi zhi xian	1
应城市	ying cheng shi	1
英德市	ying de shi	1
英吉沙县	ying ji sha xian	1
盈江县	ying jiang xian	1
荥经县	ying jing xian	1
营口市	ying kou shi	1
英山县	ying shan xian	1
营山县	ying shan xian	1
颍上县	ying shang xian	1
鹰潭市	ying tan shi	1
应县	ying xian	1
永安市	yong an shi	1
永昌县	yong chang xian	1
永城市	yong cheng shi	1
永川市	yong chuan shi	1
永春县	yong chun xian	1
永德县	yong de xian	1
永登县	yong deng xian	1
永定县	yong ding xian	1
永丰县	yong feng xian	1
永福县	yong fu xian	1
永和县	yong he xian	1
永济市	yong ji shi	1
永吉县	yong ji xian	1
永嘉县	yong jia xian	1
永靖县	yong jing xian	1
永康市	yong kang shi	1
永年县	yong nian xian	1
永宁县	yong ning xian	1
永平县	yong ping xian	1
永清县	yong qing xian	1
永仁县	yong ren xian	1
永善县	yong shan xian	1
永胜县	yong sheng xian	1
永寿县	yong shou xian	1
永顺县	yong shun xian	1
永泰县	yong tai xian	1
永新县	yong xin xian	1
永兴县	yong xing xian	1
永修县	yong xiu xian	1
永州市	yong zhou shi	1
油尖旺区	you jian wang qu	1
尤溪县	you xi xian	1
攸县	you xian	1
酉阳土家族苗族自治县	you yang tu jia zu miao zu zi zhi xian	1
友谊县	you yi xian	1
右玉县	you yu xian	1
渝北区	yu bei qu	1
禹城市	yu cheng shi	1
虞城县	yu cheng xian	1
于都县	yu du xian	1
余干县	yu gan xian	1
玉环县	yu huan xian	1
余江县	yu jiang xian	1
尉犁县	yu li xian	1
榆林市	yu lin shi	1
玉林市	yu lin shi	1
玉龙纳西族自治县	yu long na xi zu zi zhi xian	1
玉门市	yu men shi	1
裕民县	yu min xian	1
郁南县	yu nan xian	1
玉屏侗族自治县	yu ping dong zu zi zhi xian	1
余庆县	yu qing xian	1
玉山县	yu shan xian	1
榆社县	yu she xian	1
榆树市	yu shu shi	1
玉树县	yu shu xian	1
鱼台县	yu tai xian	1
于田县	yu tian xian	1
玉田县	yu tian xian	1
玉溪市	yu xi shi	1
蔚县	yu xian	1
盂县	yu xian	1
榆亚暗沙	yu ya an sha	1
余姚市	yu yao shi	1
渝中区	yu zhong qu	1
榆中县	yu zhong xian	1
禹州市	yu zhou shi	1
远安县	yuan an xian	1
元江哈尼族彝族傣族自治县	yuan jiang ha ni zu yi zu dai zu zi zhi xian	1
沅江市	yuan jiang shi	1
元朗区	yuan lang qu	1
沅陵县	yuan ling xian	1
元谋县	yuan mou xian	1
原平市	yuan ping shi	1
垣曲县	yuan qu xian	1
元氏县	yuan shi xian	1
元阳县	yuan yang xian	1
原阳县	yuan yang xian	1
岳池县	yue chi xian	1
岳普湖县	yue pu hu xian	1
乐清市	yue qing shi	1
越西县	yue xi xian	1
岳西县	yue xi xian	1
岳阳市	yue yang shi	1
岳阳县	yue yang xian	1
云安县	yun an xian	1
运城市	yun cheng shi	1
郓城县	yun cheng xian	1
云浮市	yun fu shi	1
云和县	yun he xian	1
云林县	yun lin xian	1
云龙县	yun long xian	1
云梦县	yun meng xian	1
云南	yun nan	1
云南省	yun nan sheng	1
郧西县	yun xi xian	1
郧县	yun xian	1
云县	yun xian	1
云霄县	yun xiao xian	1
云阳县	yun yang xian	1
杂多县	za duo xian	1
赞皇县	zan huang xian	1
枣强县	zao qiang xian	1
枣阳市	zao yang shi	1
枣庄市	zao zhuang shi	1
泽库县	ze ku xian	1
泽普县	ze pu xian	1
泽州县	ze zhou xian	1
增城市	zeng cheng shi	1
闸北区	zha bei qu	1
札达县	zha da xian	1
扎赉特旗	zha lai te qi	1
扎兰屯市	zha lan tun shi	1
扎鲁特旗	zha lu te qi	1
扎囊县	zha nang xian	1
柞水县	zha shui xian	1
沾化县	zhan hua xian	1
湛江市	zhan jiang shi	1
沾益县	zhan yi xian	1
张北县	zhang bei xian	1
彰化市	zhang hua shi	1
彰化县	zhang hua xian	1
张家川回族自治县	zhang jia chuan hui zu zi zhi xian	1
张家港市	zhang jia gang shi	1
张家界市	zhang jia jie shi	1
张家口市	zhang jia kou shi	1
漳平市	zhang ping shi	1
漳浦县	zhang pu xian	1
章丘市	zhang qiu shi	1
樟树市	zhang shu shi	1
彰武县	zhang wu xian	1
漳县	zhang xian	1
张掖市	zhang ye shi	1
漳州市	zhang zhou shi	1
长子县	zhang zi xian	1
诏安县	zhao an xian	1
肇东市	zhao dong shi	1
昭觉县	zhao jue xian	1
昭平县	zhao ping xian	1
肇庆市	zhao qing shi	1
昭苏县	zhao su xian	1
昭通市	zhao tong shi	1
赵县	zhao xian	1
招远市	zhao yuan shi	1
肇源县	zhao yuan xian	1
肇州县	zhao zhou xian	1
柘城县	zhe cheng xian	1
浙江	zhe jiang	1
浙江省	zhe jiang sheng	1
柘荣县	zhe rong xian	1
镇安县	zhen an xian	1
镇巴县	zhen ba xian	1
贞丰县	zhen feng xian	1
镇江市	zhen jiang shi	1
镇康县	zhen kang xian	1
镇赉县	zhen lai xian	1
镇宁布依族苗族自治县	zhen ning bu yi zu miao zu zi zhi xian	1
镇坪县	zhen ping xian	1
镇平县	zhen ping xian	1
镇雄县	zhen xiong xian	1
镇远县	zhen yuan xian	1
镇原县	zhen yuan xian	1
镇沅彝族哈尼族拉祜族自治县	zhen yuan yi zu ha ni zu la hu zu zi zhi xian	1
正安县	zheng an xian	1
正定县	zheng ding xian	1
政和县	zheng he xian	1
正蓝旗	zheng lan qi	1
正宁县	zheng ning xian	1
正镶白旗	zheng xiang bai qi	1
正阳县	zheng yang xian	1
郑州市	zheng zhou shi	1
志丹县	zhi dan xian	1
治多县	zhi duo xian	1
芷江侗族自治县	zhi jiang dong zu zi zhi xian	1
枝江市	zhi jiang shi	1
织金县	zhi jin xian	1
仲巴县	zhong ba xian	1
中方县	zhong fang xian	1
中江县	zhong jiang xian	1
中礁	zhong jiao	1
中康暗沙	zhong kang an sha	1
中牟县	zhong mu xian	1
中宁县	zhong ning xian	1
中山市	zhong shan shi	1
钟山县	zhong shan xian	1
中卫市	zhong wei shi	1
中西区	zhong xi qu	1
忠县	zhong xian	1
钟祥市	zhong xiang shi	1
中阳县	zhong yang xian	1
中业岛	zhong ye dao	1
周口市	zhou kou shi	1
周宁县	zhou ning xian	1
舟曲县	zhou qu xian	1
舟山市	zhou shan shi	1
周至县	zhou zhi xian	1
竹北市	zhu bei shi	1
诸城市	zhu cheng shi	1
珠海市	zhu hai shi	1
诸暨市	zhu ji shi	1
驻马店市	zhu ma dian shi	1
竹山县	zhu shan xian	1
竹溪县	zhu xi xian	1
株洲市	zhu zhou shi	1
株洲县	zhu zhou xian	1
庄河市	zhuang he shi	1
庄浪县	zhuang lang xian	1
准格尔旗	zhun ge er qi	1
涿鹿县	zhuo lu xian	1
卓尼县	zhuo ni xian	1
涿州市	zhuo zhou shi	1
卓资县	zhuo zi xian	1
淄博市	zi bo shi	1
子长县	zi chang xian	1
自贡市	zi gong shi	1
秭归县	zi gui xian	1
紫金县	zi jin xian	1
梓潼县	zi tong xian	1
资溪县	zi xi xian	1
资兴市	zi xing shi	1
资阳市	zi yang shi	1
紫阳县	zi yang xian	1
资源县	zi yuan xian	1
紫云苗族布依族自治县	zi yun miao zu bu yi zu zi zhi xian	1
资中县	zi zhong xian	1
子洲县	zi zhou xian	1
枞阳县	zong yang xian	1
邹城市	zou cheng shi	1
邹平县	zou ping xian	1
遵化市	zun hua shi	1
遵义市	zun yi shi	1
遵义县	zun yi xian	1
左贡县	zuo gong xian	1
左权县	zuo quan xian	1
左云县	zuo yun xian	1
