阿继电器	a ji dian qi	1
爱康科技	ai kang ke ji	1
安彩高科	an cai gao ke	1
鞍钢股份	an gang gu fen	1
鞍合成	an he cheng	1
鞍山信托	an shan xin tuo	1
安塑股份	an su gu fen	1
安泰集团	an tai ji tuan	1
安源股份	an yuan gu fen	1
八一钢铁	ba yi gang tie	1
百川股份	bai chuan gu fen	1
百大集团	bai da ji tuan	1
百科药业	bai ke yao ye	1
百利电气	bai li dian qi	1
佰利联	bai li lian	1
白猫股份	bai mao gu fen	1
百润股份	bai run gu fen	1
宝鼎重工	bao ding zhong gong	1
宝光股份	bao guang gu fen	1
宝华实业	bao hua shi ye	1
宝康灵活配置	bao kang ling huo pei zhi	1
宝康消费品	bao kang xiao fei pin	1
宝康债券	bao kang zhai quan	1
宝莱特	bao lai te	1
宝利沥青	bao li li qing	1
宝莫股份	bao mo gu fen	1
保税科技	bao shui ke ji	1
宝硕股份	bao shuo gu fen	1
宝泰隆	bao tai long	1
包头铝业	bao tou lv ye	1
宝信股	bao xin gu	1
宝馨科技	bao xin ke ji	1
宝新能源	bao xin neng yuan	1
宝盈策略	bao ying ce lue	1
宝盈泛沿海	bao ying fan yan hai	1
宝盈鸿利收益	bao ying hong li shou yi	1
宝盈增强收益	bao ying zeng qiang shou yi	1
宝盈资源	bao ying zi yuan	1
宝盈资源优选	bao ying zi yuan you xuan	1
北大高科	bei da gao ke	1
北大科技	bei da ke ji	1
北方股份	bei fang gu fen	1
北方国际	bei fang guo ji	1
北方天鸟	bei fang tian niao	1
北海新力	bei hai xin li	1
北京巴士	bei jing ba shi	1
北京城建	bei jing cheng jian	1
北京城乡	bei jing cheng xiang	1
北京化二	bei jing hua er	1
北京华联	bei jing hua lian	1
北京旅游	bei jing lv you	1
北特钢	bei te gang	1
倍特高新	bei te gao xin	1
北新建材	bei xin jian cai	1
北亚集团	bei ya ji tuan	1
贝因美	bei yin mei	1
比特科技	bi te ke ji	1
标准股份	biao zhun gu fen	1
滨海能源	bin hai neng yuan	1
滨州活塞	bin zhou huo sai	1
冰山橡塑	bing shan xiang su	1
渤海物流	bo hai wu liu	1
博汇发债	bo hui fa zhai	1
博汇转债	bo hui zhuan zhai	1
博瑞传播	bo rui chuan bo	1
博时第三产业	bo shi di san chan ye	1
博时价值贰号	bo shi jia zhi er hao	1
博时精选	bo shi jing xuan	1
博时平衡配置	bo shi ping heng pei zhi	1
博时特许价值	bo shi te xu jia zhi	1
博时稳定价值	bo shi wen ding jia zhi	1
博时新兴成长	bo shi xin xing cheng zhang	1
博时主题行业	bo shi zhu ti hang ye	1
博威合金	bo wei he jin	1
步森股份	bu sen gu fen	1
彩虹股份	cai hong gu fen	1
沧州大化	cang zhou da hua	1
沧州化工	cang zhou hua gong	1
草原兴发	cao yuan xing fa	1
长安信息	chang an xin xi	1
常宝股份	chang bao gu fen	1
长城安心回报	chang cheng an xin hui bao	1
长城久富	chang cheng jiu fu	1
长城久恒	chang cheng jiu heng	1
长城开发	chang cheng kai fa	1
长城品牌	chang cheng pin pai	1
长城稳健增利	chang cheng wen jian zeng li	1
长城消费增值	chang cheng xiao fei zeng zhi	1
长城信息	chang cheng xin xi	1
长春长铃	chang chun chang ling	1
长春燃气	chang chun ran qi	1
长春热缩	chang chun re suo	1
长电科技	chang dian ke ji	1
长风特电	chang feng te dian	1
长丰通信	chang feng tong xin	1
长海股份	chang hai gu fen	1
昌河股份	chang he gu fen	1
昌红科技	chang hong ke ji	1
长江股份	chang jiang gu fen	1
长江精工	chang jiang jing gong	1
长江控股	chang jiang kong gu	1
长江投资	chang jiang tou zi	1
昌九股份	chang jiu gu fen	1
常林股份	chang lin gu fen	1
长荣股份	chang rong gu fen	1
常山股份	chang shan gu fen	1
长盛成长价值	chang sheng cheng zhang jia zhi	1
长盛创新先锋	chang sheng chuang xin xian feng	1
长盛动态精选	chang sheng dong tai jing xuan	1
长盛积极配置	chang sheng ji ji pei zhi	1
长盛同德主题	chang sheng tong de zhu ti	1
长盛同智优势	chang sheng tong zhi you shi	1
长盛中证	chang sheng zhong zheng	1
长信双利优选	chang xin shuang li you xuan	1
长信银利精选	chang xin yin li jing xuan	1
长信增利动态	chang xin zeng li dong tai	1
长兴实业	chang xing shi ye	1
长盈精密	chang ying jing mi	1
长运股份	chang yun gu fen	1
长征电器	chang zheng dian qi	1
巢东	chao dong	1
超日太阳	chao ri tai yang	1
超声电子	chao sheng dian zi	1
郴电国际	chen dian guo ji	1
晨光生物	chen guang sheng wu	1
诚成文化	cheng cheng wen hua	1
承德钒钛	cheng de fan tai	1
承德露露	cheng de lu lu	1
成都华联	cheng du hua lian	1
成量股份	cheng liang gu fen	1
成霖股份	cheng lin gu fen	1
成商集团	cheng shang ji tuan	1
重庆百货	chong qing bai huo	1
重庆港九	chong qing gang jiu	1
重庆啤酒	chong qing pi jiu	1
重庆实业	chong qing shi ye	1
初灵信息	chu ling xin xi	1
楚天高速	chu tian gao su	1
雏鹰农牧	chu ying nong mu	1
川长江	chuan chang jiang	1
传化股份	chuan hua gu fen	1
川双马	chuan shuang ma	1
川投长钢	chuan tou chang gang	1
川投控股	chuan tou kong gu	1
川投转债	chuan tou zhuan zhai	1
创兴科技	chuang xing ke ji	1
创业环保	chuang ye huan bao	1
创智科技	chuang zhi ke ji	1
春兰股份	chun lan gu fen	1
春兴精工	chun xing jing gong	1
大成策略回报	da cheng ce lue hui bao	1
大成创新成长	da cheng chuang xin cheng zhang	1
大成股份	da cheng gu fen	1
大成积极成长	da cheng ji ji cheng zhang	1
大成价值增长	da cheng jia zhi zeng zhang	1
大成精选增值	da cheng jing xuan zeng zhi	1
大成景阳	da cheng jing yang	1
大成蓝筹稳健	da cheng lan chou wen jian	1
大成强债	da cheng qiang zhai	1
大成生命周期	da cheng sheng ming zhou qi	1
大成优选	da cheng you xuan	1
大成债券	da cheng zhai quan	1
大地基础	da di ji chu	1
达刚路机	da gang lu ji	1
大化股	da hua gu	1
大华农	da hua nong	1
达华智能	da hua zhi neng	1
大江股份	da jiang gu fen	1
大金重工	da jin zhong gong	1
大康牧业	da kang mu ye	1
大冷股份	da leng gu fen	1
大连渤海	da lian bo hai	1
大连创世	da lian chuang shi	1
大连电瓷	da lian dian ci	1
大连国际	da lian guo ji	1
大连金牛	da lian jin niu	1
大连热电	da lian re dian	1
大连友谊	da lian you yi	1
大庆华科	da qing hua ke	1
大庆联谊	da qing lian yi	1
大厦股份	da sha gu fen	1
大同水泥	da tong shui ni	1
大显股份	da xian gu fen	1
大亚股份	da ya gu fen	1
大杨创世	da yang chuang shi	1
大冶特钢	da ye te gang	1
大盈	da ying	1
大元股份	da yuan gu fen	1
大众公用	da zhong gong yong	1
大众股	da zhong gu	1
大众交通	da zhong jiao tong	1
大众科创	da zhong ke chuang	1
丹东化纤	dan dong hua xian	1
道博	dao bo	1
德力股份	de li gu fen	1
德赛电池	de sai dian chi	1
德盛安心成长	de sheng an xin cheng zhang	1
德盛红利	de sheng hong li	1
德盛精选	de sheng jing xuan	1
德盛稳健	de sheng wen jian	1
德盛小盘	de sheng xiao pan	1
德盛优势	de sheng you shi	1
灯塔油漆	deng ta you qi	1
迪安诊断	di an zhen duan	1
迪马股份	di ma gu fen	1
迪威视讯	di wei shi xun	1
第一百货	di yi bai huo	1
第一纺织	di yi fang zhi	1
第一铅笔	di yi qian bi	1
第一食品	di yi shi pin	1
第一医药	di yi yi yao	1
电器股份	dian qi gu fen	1
鼎盛天工	ding sheng tian gong	1
鼎天科技	ding tian ke ji	1
东宝生物	dong bao sheng wu	1
东贝	dong bei	1
东北电	dong bei dian	1
东北电气	dong bei dian qi	1
东北高速	dong bei gao su	1
东贝股	dong bei gu	1
东北制药	dong bei zhi yao	1
东电	dong dian	1
东电股	dong dian gu	1
东方宾馆	dong fang bin guan	1
东方策略成长	dong fang ce lue cheng zhang	1
东方创业	dong fang chuang ye	1
东方电机	dong fang dian ji	1
东方锅炉	dong fang guo lu	1
东方国信	dong fang guo xin	1
东方金钰	dong fang jin yu	1
东方精选	dong fang jing xuan	1
东方铁塔	dong fang tie ta	1
东方通信	dong fang tong xin	1
东方稳健回报	dong fang wen jian hui bao	1
东风科技	dong feng ke ji	1
东富龙	dong fu long	1
东莞控股	dong guan kong gu	1
东光微电	dong guang wei dian	1
东海股份	dong hai gu fen	1
东湖高新	dong hu gao xin	1
东湖新	dong hu xin	1
东华实业	dong hua shi ye	1
东软股份	dong ruan gu fen	1
东软载波	dong ruan zai bo	1
东盛科技	dong sheng ke ji	1
东泰	dong tai	1
东泰控股	dong tai kong gu	1
东吴动力	dong wu dong li	1
东吴行业轮动	dong wu hang ye lun dong	1
东吴嘉禾	dong wu jia he	1
东吴优信稳健	dong wu you xin wen jian	1
东新电碳	dong xin dian tan	1
东信股	dong xin gu	1
都市股份	du shi gu fen	1
盾安环境	dun an huan jing	1
敦煌种业	dun huang zhong ye	1
多佳股份	duo jia gu fen	1
多伦股份	duo lun gu fen	1
鄂绒	e rong	1
鄂绒股	e rong gu	1
二纺	er fang	1
二纺股	er fang gu	1
法拉电子	fa la dian zi	1
泛海建设	fan hai jian she	1
钒钛债	fan tai zhai	1
方向光电	fang xiang guang dian	1
方兴科技	fang xing ke ji	1
方正科技	fang zheng ke ji	1
方正证券	fang zheng zheng quan	1
飞彩股份	fei cai gu fen	1
菲菲农业	fei fei nong ye	1
飞力达	fei li da	1
飞亚股份	fei ya gu fen	1
丰东股份	feng dong gu fen	1
风范股份	feng fan gu fen	1
丰华股份	feng hua gu fen	1
凤凰股份	feng huang gu fen	1
丰乐种业	feng le zhong ye	1
风神股份	feng shen gu fen	1
丰原药业	feng yuan yao ye	1
佛山照明	fo shan zhao ming	1
福安药业	fu an yao ye	1
富邦科技	fu bang ke ji	1
富春环保	fu chun huan bao	1
福地科技	fu di ke ji	1
富国天成	fu guo tian cheng	1
富国天鼎	fu guo tian ding	1
富国天丰	fu guo tian feng	1
富国天利	fu guo tian li	1
富国天源	fu guo tian yuan	1
复华实业	fu hua shi ye	1
福建南纸	fu jian nan zhi	1
福建三农	fu jian san nong	1
涪陵电力	fu ling dian li	1
富龙热力	fu long re li	1
福日股份	fu ri gu fen	1
抚顺特钢	fu shun te gang	1
福田汽车	fu tian qi che	1
福星科技	fu xing ke ji	1
复星实业	fu xing shi ye	1
复星医药	fu xing yi yao	1
福州大通	fu zhou da tong	1
赣南果业	gan nan guo ye	1
钢联股份	gang lian gu fen	1
高淳陶瓷	gao chun tao ci	1
高鸿股份	gao hong gu fen	1
高盟新材	gao meng xin cai	1
高斯达	gao si da	1
高新发展	gao xin fa zhan	1
歌华发债	ge hua fa zhai	1
歌华有线	ge hua you xian	1
工大高新	gong da gao xin	1
工大首创	gong da shou chuang	1
工益股份	gong yi gu fen	1
工银核心价值	gong yin he xin jia zhi	1
工银红利股票	gong yin hong li gu piao	1
工银精选平衡	gong yin jing xuan ping heng	1
工银强债	gong yin qiang zhai	1
工银全球配置	gong yin quan qiu pei zhi	1
工银瑞信大盘	gong yin rui xin da pan	1
工银稳健成长	gong yin wen jian cheng zhang	1
工银信用添利	gong yin xin yong tian li	1
公用科技	gong yong ke ji	1
冠昊生物	guan hao sheng wu	1
光彩建设	guang cai jian she	1
光大红利股票	guang da hong li gu piao	1
光大量化核心	guang da liang hua he xin	1
光大新增长	guang da xin zeng zhang	1
光大优势	guang da you shi	1
光大增利	guang da zeng li	1
广电电气	guang dian dian qi	1
广电电子	guang dian dian zi	1
广电网络	guang dian wang luo	1
广电信息	guang dian xin xi	1
广东明珠	guang dong ming zhu	1
广发策略优选	guang fa ce lue you xuan	1
广发大盘成长	guang fa da pan cheng zhang	1
广发核心精选	guang fa he xin jing xuan	1
广发稳健	guang fa wen jian	1
广发增强债券	guang fa zeng qiang zhai quan	1
光华控股	guang hua kong gu	1
广济药业	guang ji yao ye	1
广聚能源	guang ju neng yuan	1
光明家具	guang ming jia ju	1
广西红日	guang xi hong ri	1
光线传媒	guang xian chuan mei	1
光正钢构	guang zheng gang gou	1
广州国光	guang zhou guo guang	1
广州控股	guang zhou kong gu	1
广州浪奇	guang zhou lang qi	1
广州药业	guang zhou yao ye	1
广州友谊	guang zhou you yi	1
桂冠电力	gui guan dian li	1
桂林集琦	gui lin ji qi	1
桂林旅游	gui lin lv you	1
国电南自	guo dian nan zi	1
国电清新	guo dian qing xin	1
国栋建设	guo dong jian she	1
国富潜力	guo fu qian li	1
国富深化价值	guo fu shen hua jia zhi	1
国富收益	guo fu shou yi	1
国富弹性	guo fu tan xing	1
国光瓷业	guo guang ci ye	1
国海强化收益	guo hai qiang hua shou yi	1
国际大厦	guo ji da sha	1
国际实业	guo ji shi ye	1
国旅申购	guo lv shen gou	1
国能集团	guo neng ji tuan	1
国泰沪深	guo tai hu shen	1
国泰金鼎价值	guo tai jin ding jia zhi	1
国泰金龙行业	guo tai jin long hang ye	1
国泰金龙债券	guo tai jin long zhai quan	1
国泰金鹿保本期	guo tai jin lu bao ben qi	1
国泰金马稳健	guo tai jin ma wen jian	1
国泰金牛创新	guo tai jin niu chuang xin	1
国泰金鹏蓝筹	guo tai jin peng lan chou	1
国泰金鹰增长	guo tai jin ying zeng zhang	1
国投电力	guo tou dian li	1
国投瑞福进取	guo tou rui fu jin qu	1
国投瑞福优先	guo tou rui fu you xian	1
国投瑞银成长	guo tou rui yin cheng zhang	1
国投瑞银创新	guo tou rui yin chuang xin	1
国投瑞银核心	guo tou rui yin he xin	1
国投瑞银景气	guo tou rui yin jing qi	1
国投瑞银融华	guo tou rui yin rong hua	1
国投瑞银稳定	guo tou rui yin wen ding	1
国投瑞银稳健	guo tou rui yin wen jian	1
国投转债	guo tou zhuan zhai	1
国祥股份	guo xiang gu fen	1
国星光电	guo xing guang dian	1
国药科技	guo yao ke ji	1
哈慈股份	ha ci gu fen	1
哈药集团	ha yao ji tuan	1
海德股份	hai de gu fen	1
海富通贰号	hai fu tong er hao	1
海富通股票	hai fu tong gu piao	1
海富通海外	hai fu tong hai wai	1
海富通回报	hai fu tong hui bao	1
海富通精选	hai fu tong jing xuan	1
海富通收益	hai fu tong shou yi	1
海富通稳健	hai fu tong wen jian	1
海富通优势	hai fu tong you shi	1
海航股	hai hang gu	1
海立	hai li	1
海立股	hai li gu	1
海立美达	hai li mei da	1
海伦哲	hai lun zhe	1
海螺型材	hai luo xing cai	1
海纳	hai na	1
海南高速	hai nan gao su	1
海南航空	hai nan hang kong	1
海南瑞泽	hai nan rui ze	1
海南橡胶	hai nan xiang jiao	1
海通集团	hai tong ji tuan	1
海王生物	hai wang sheng wu	1
海信电器	hai xin dian qi	1
海欣股	hai xin gu	1
海欣股份	hai xin gu fen	1
海星科技	hai xing ke ji	1
海药	hai yao	1
海印股份	hai yin gu fen	1
海源机械	hai yuan ji xie	1
海运发债	hai yun fa zhai	1
邯郸钢铁	han dan gang tie	1
汉得信息	han de xin xi	1
翰宇药业	han yu yao ye	1
杭钢股份	hang gang gu fen	1
杭锅股份	hang guo gu fen	1
航天电器	hang tian dian qi	1
航天动力	hang tian dong li	1
航天机电	hang tian ji dian	1
航天科技	hang tian ke ji	1
航天通信	hang tian tong xin	1
航天信息	hang tian xin xi	1
航天中汇	hang tian zhong hui	1
河北华玉	he bei hua yu	1
合肥百货	he fei bai huo	1
和光商务	he guang shang wu	1
合加资源	he jia zi yuan	1
合金投资	he jin tou zi	1
和顺电气	he shun dian qi	1
黑龙股份	hei long gu fen	1
恒丰纸业	heng feng zhi ye	1
恒和制药	heng he zhi yao	1
恒生电子	heng sheng dian zi	1
恒顺电气	heng shun dian qi	1
恒泰艾普	heng tai ai pu	1
亨通光电	heng tong guang dian	1
恒源煤电	heng yuan mei dian	1
洪城股份	hong cheng gu fen	1
洪都航空	hong du hang kong	1
宏峰	hong feng	1
红河光明	hong he guang ming	1
鸿路钢构	hong lu gang gou	1
鸿特精密	hong te jing mi	1
红星发展	hong xing fa zhan	1
宏源证券	hong yuan zheng quan	1
湖北车桥	hu bei che qiao	1
湖北金环	hu bei jin huan	1
湖北兴化	hu bei xing hua	1
沪昌特钢	hu chang te gang	1
湖大科教	hu da ke jiao	1
沪电股份	hu dian gu fen	1
沪科技	hu ke ji	1
湖南海利	hu nan hai li	1
湖南投资	hu nan tou zi	1
华安	hua an	1
华安策略优选	hua an ce lue you xuan	1
华安创新	hua an chuang xin	1
华安国际配置	hua an guo ji pei zhi	1
华安核心优选	hua an he xin you xuan	1
华安宏利股票	hua an hong li gu piao	1
华安稳定收益	hua an wen ding shou yi	1
华安中国股	hua an zhong guo gu	1
华安中小盘成长	hua an zhong xiao pan cheng zhang	1
华宝策略	hua bao ce lue	1
华宝大盘精选	hua bao da pan jing xuan	1
华宝动力	hua bao dong li	1
华宝行业精选	hua bao hang ye jing xuan	1
华宝收益增长	hua bao shou yi zeng zhang	1
华宝先进成长	hua bao xian jin cheng zhang	1
华宝兴业海外	hua bao xing ye hai wai	1
华北高速	hua bei gao su	1
华北制药	hua bei zhi yao	1
华策影视	hua ce ying shi	1
华电股	hua dian gu	1
华电国际	hua dian guo ji	1
华东电脑	hua dong dian nao	1
华东科技	hua dong ke ji	1
华东医药	hua dong yi yao	1
化二	hua er	1
华发股份	hua fa gu fen	1
华峰超纤	hua feng chao xian	1
华富策略精选	hua fu ce lue jing xuan	1
华富成长趋势	hua fu cheng zhang qu shi	1
华富竞争力	hua fu jing zheng li	1
华富收益增强	hua fu shou yi zeng qiang	1
华冠科技	hua guan ke ji	1
华光股份	hua guang gu fen	1
华光陶瓷	hua guang tao ci	1
华晶钻石	hua jing zuan shi	1
华立科技	hua li ke ji	1
华立控股	hua li kong gu	1
华立药业	hua li yao ye	1
华联超市	hua lian chao shi	1
华联商城	hua lian shang cheng	1
华联商厦	hua lian shang sha	1
桦林轮胎	hua lin lun tai	1
华龙集团	hua long ji tuan	1
华能国际	hua neng guo ji	1
华能债	hua neng zhai	1
华商领先	hua shang ling xian	1
华商盛世成长	hua shang sheng shi cheng zhang	1
华天酒店	hua tian jiu dian	1
骅威股份	hua wei gu fen	1
华伍股份	hua wu gu fen	1
华夏策略精选	hua xia ce lue jing xuan	1
华夏成长	hua xia cheng zhang	1
华夏大盘精选	hua xia da pan jing xuan	1
华夏复兴	hua xia fu xing	1
华夏行业精选	hua xia hang ye jing xuan	1
华夏红利	hua xia hong li	1
华夏回报	hua xia hui bao	1
华夏回报二号	hua xia hui bao er hao	1
华夏平稳增长	hua xia ping wen zeng zhang	1
华夏全球精选	hua xia quan qiu jing xuan	1
华夏上证	hua xia shang zheng	1
华夏希望债券	hua xia xi wang zhai quan	1
华夏优势增长	hua xia you shi zeng zhang	1
华夏债券	hua xia zhai quan	1
华夏债券类	hua xia zhai quan lei	1
华夏中小板	hua xia zhong xiao ban	1
华新股	hua xin gu	1
华信股份	hua xin gu fen	1
华新水泥	hua xin shui ni	1
华星化工	hua xing hua gong	1
华阳科技	hua yang ke ji	1
华仪电气	hua yi dian qi	1
华一投资	hua yi tou zi	1
华源发	hua yuan fa	1
华源发展	hua yuan fa zhan	1
华源股份	hua yuan gu fen	1
华源制药	hua yuan zhi yao	1
环保股份	huan bao gu fen	1
寰岛实业	huan dao shi ye	1
黄海股份	huang hai gu fen	1
黄河旋风	huang he xuan feng	1
黄山股	huang shan gu	1
黄山旅游	huang shan lv you	1
惠博普	hui bo pu	1
辉丰股份	hui feng gu fen	1
汇丰晋信策略	hui feng jin xin ce lue	1
汇丰晋信龙腾	hui feng jin xin long teng	1
汇丰晋信平稳	hui feng jin xin ping wen	1
辉隆股份	hui long gu fen	1
汇添富成长	hui tian fu cheng zhang	1
汇添富均衡	hui tian fu jun heng	1
汇添富蓝筹稳健	hui tian fu lan chou wen jian	1
汇添富优势	hui tian fu you shi	1
汇添富增强债券	hui tian fu zeng qiang zhai quan	1
汇通水利	hui tong shui li	1
汇源通信	hui yuan tong xin	1
济百	ji bai	1
机电股	ji dian gu	1
吉发	ji fa	1
基金安久	ji jin an jiu	1
基金安瑞	ji jin an rui	1
基金安顺	ji jin an shun	1
基金安信	ji jin an xin	1
基金汉博	ji jin han bo	1
基金汉鼎	ji jin han ding	1
基金鸿飞	ji jin hong fei	1
基金金鼎	ji jin jin ding	1
基金金泰	ji jin jin tai	1
基金金鑫	ji jin jin xin	1
基金金元	ji jin jin yuan	1
基金景福	ji jin jing fu	1
基金景阳	ji jin jing yang	1
基金景业	ji jin jing ye	1
基金久富	ji jin jiu fu	1
基金开元	ji jin kai yuan	1
基金科汇	ji jin ke hui	1
基金科瑞	ji jin ke rui	1
基金隆元	ji jin long yuan	1
基金普丰	ji jin pu feng	1
基金普华	ji jin pu hua	1
基金普惠	ji jin pu hui	1
基金普润	ji jin pu run	1
基金天华	ji jin tian hua	1
基金天元	ji jin tian yuan	1
基金通宝	ji jin tong bao	1
基金同德	ji jin tong de	1
基金通干	ji jin tong gan	1
基金同智	ji jin tong zhi	1
基金兴安	ji jin xing an	1
基金兴华	ji jin xing hua	1
基金兴科	ji jin xing ke	1
基金兴业	ji jin xing ye	1
基金裕华	ji jin yu hua	1
基金裕元	ji jin yu yuan	1
吉林化工	ji lin hua gong	1
吉林化纤	ji lin hua xian	1
吉林炭素	ji lin tan su	1
吉林纸业	ji lin zhi ye	1
济南百货	ji nan bai huo	1
济南钢铁	ji nan gang tie	1
吉轻工	ji qing gong	1
嘉宝集团	jia bao ji tuan	1
嘉麟杰	jia lin jie	1
佳隆股份	jia long gu fen	1
嘉实策略增长	jia shi ce lue zeng zhang	1
嘉实超短债	jia shi chao duan zhai	1
嘉实成长	jia shi cheng zhang	1
嘉实多元	jia shi duo yuan	1
嘉实服务	jia shi fu wu	1
嘉实海外中国	jia shi hai wai zhong guo	1
佳士科技	jia shi ke ji	1
嘉实稳健	jia shi wen jian	1
嘉实研究精选	jia shi yan jiu jing xuan	1
嘉实优质企业	jia shi you zhi qi ye	1
嘉实增长	jia shi zeng zhang	1
嘉实债券	jia shi zhai quan	1
嘉实主题精选	jia shi zhu ti jing xuan	1
嘉寓股份	jia yu gu fen	1
建峰化工	jian feng hua gong	1
尖峰集团	jian feng ji tuan	1
建新股份	jian xin gu fen	1
建信恒久价值	jian xin heng jiu jia zhi	1
建信精选	jian xin jing xuan	1
建信稳定增利	jian xin wen ding zeng li	1
建信优化配置	jian xin you hua pei zhi	1
建信优势动力	jian xin you shi dong li	1
建信优选成长	jian xin you xuan cheng zhang	1
江粉磁材	jiang fen ci cai	1
江淮动力	jiang huai dong li	1
江淮汽车	jiang huai qi che	1
江铃汽车	jiang ling qi che	1
江南高纤	jiang nan gao xian	1
江南水务	jiang nan shui wu	1
江南重工	jiang nan zhong gong	1
江汽股份	jiang qi gu fen	1
江山股份	jiang shan gu fen	1
江苏开元	jiang su kai yuan	1
江苏旷达	jiang su kuang da	1
江苏琼花	jiang su qiong hua	1
江苏三友	jiang su san you	1
江苏舜天	jiang su shun tian	1
江苏索普	jiang su suo pu	1
江苏吴中	jiang su wu zhong	1
江苏阳光	jiang su yang guang	1
江西长运	jiang xi chang yun	1
江西纸业	jiang xi zhi ye	1
江中药业	jiang zhong yao ye	1
江钻股份	jiang zuan gu fen	1
交大昂立	jiao da ang li	1
交大科技	jiao da ke ji	1
交大南洋	jiao da nan yang	1
胶带股份	jiao dai gu fen	1
交银成长	jiao yin cheng zhang	1
交银环球	jiao yin huan qiu	1
交银精选	jiao yin jing xuan	1
交银蓝筹	jiao yin lan chou	1
交银稳健	jiao yin wen jian	1
交银增利	jiao yin zeng li	1
交运股份	jiao yun gu fen	1
焦作万方	jiao zuo wan fang	1
焦作鑫安	jiao zuo xin an	1
捷成股份	jie cheng gu fen	1
杰赛科技	jie sai ke ji	1
捷顺科技	jie shun ke ji	1
金杯电工	jin bei dian gong	1
金杯汽车	jin bei qi che	1
津滨发展	jin bin fa zhan	1
金城股份	jin cheng gu fen	1
金德发展	jin de fa zhan	1
金地集团	jin di ji tuan	1
金帝建设	jin di jian she	1
金地债	jin di zhai	1
金发科技	jin fa ke ji	1
金丰投资	jin feng tou zi	1
锦富新材	jin fu xin cai	1
锦港	jin gang	1
锦港股	jin gang gu	1
金固股份	jin gu gu fen	1
金禾实业	jin he shi ye	1
金花股份	jin hua gu fen	1
锦江股	jin jiang gu	1
锦江股份	jin jiang gu fen	1
锦江投资	jin jiang tou zi	1
金晶科技	jin jing ke ji	1
金荔科技	jin li ke ji	1
金陵药业	jin ling yao ye	1
金龙汽车	jin long qi che	1
锦旅	jin lv	1
锦旅股	jin lv gu	1
金马股份	jin ma gu fen	1
金马集团	jin ma ji tuan	1
金牛能源	jin niu neng yuan	1
金牛实业	jin niu shi ye	1
金桥股	jin qiao gu	1
金瑞科技	jin rui ke ji	1
金山股	jin shan gu	1
金山股份	jin shan gu fen	1
金山开发	jin shan kai fa	1
劲胜股份	jin sheng gu fen	1
锦投	jin tou	1
锦投股	jin tou gu	1
晋西车轴	jin xi che zhou	1
金新农	jin xin nong	1
金信诺	jin xin nuo	1
金鹰股份	jin ying gu fen	1
金鹰红利	jin ying hong li	1
金鹰优选	jin ying you xuan	1
金鹰中小盘	jin ying zhong xiao pan	1
金宇集团	jin yu ji tuan	1
金元宝石动力	jin yuan bao shi dong li	1
金元成长动力	jin yuan cheng zhang dong li	1
金洲管道	jin zhou guan dao	1
锦州六陆	jin zhou liu lu	1
锦州石化	jin zhou shi hua	1
精密股份	jing mi gu fen	1
景顺动力平衡	jing shun dong li ping heng	1
景顺精选蓝筹	jing shun jing xuan lan chou	1
景顺内需增长	jing shun nei xu zeng zhang	1
景顺新兴成长	jing shun xin xing cheng zhang	1
景顺优选股票	jing shun you xuan gu piao	1
景顺治理股票	jing shun zhi li gu piao	1
景顺资源垄断	jing shun zi yuan long duan	1
经纬电材	jing wei dian cai	1
经纬纺机	jing wei fang ji	1
京西旅游	jing xi lv you	1
靖远煤电	jing yuan mei dian	1
九江化纤	jiu jiang hua xian	1
九龙电力	jiu long dian li	1
巨潮小盘	ju chao xiao pan	1
聚光科技	ju guang ke ji	1
聚龙股份	ju long gu fen	1
巨轮股份	ju lun gu fen	1
巨轮转债	ju lun zhuan zhai	1
聚友网络	ju you wang luo	1
凯地	kai di	1
凯迪电力	kai di dian li	1
凯恩股份	kai en gu fen	1
开开股	kai kai gu	1
开开实业	kai kai shi ye	1
凯乐科技	kai le ke ji	1
开滦股份	kai luan gu fen	1
凯马股	kai ma gu	1
凯美特气	kai mei te qi	1
凯诺科技	kai nuo ke ji	1
康得新	kang de xin	1
康赛	kang sai	1
科大创新	ke da chuang xin	1
科达机电	ke da ji dian	1
科华生物	ke hua sheng wu	1
科锐配电	ke rui pei dian	1
科斯伍德	ke si wu de	1
科泰电源	ke tai dian yuan	1
科苑集团	ke yuan ji tuan	1
空港股份	kong gang gu fen	1
昆明机床	kun ming ji chuang	1
莱钢股份	lai gang gu fen	1
莱茵置业	lai yin zhi ye	1
兰宝信息	lan bao xin xi	1
蓝丰生化	lan feng sheng hua	1
兰光科技	lan guang ke ji	1
兰花科创	lan hua ke chuang	1
兰陵陈香	lan ling chen xiang	1
兰生股份	lan sheng gu fen	1
蓝石化	lan shi hua	1
蓝星清洗	lan xing qing xi	1
兰州黄河	lan zhou huang he	1
兰州铝业	lan zhou lv ye	1
兰州民百	lan zhou min bai	1
浪潮软件	lang chao ruan jian	1
浪潮信息	lang chao xin xi	1
朗源股份	lang yuan gu fen	1
乐凯胶片	le kai jiao pian	1
乐山电力	le shan dian li	1
雷柏科技	lei bo ke ji	1
雷曼光电	lei man guang dian	1
理邦仪器	li bang yi qi	1
利嘉股份	li jia gu fen	1
丽江旅游	li jiang lv you	1
利源铝业	li yuan lv ye	1
力源信息	li yuan xin xi	1
丽珠集团	li zhu ji tuan	1
联创光电	lian chuang guang dian	1
联华股	lian hua gu	1
莲花味精	lian hua wei jing	1
联通国脉	lian tong guo mai	1
联益	lian yi	1
辽国际	liao guo ji	1
辽宁时代	liao ning shi dai	1
辽源得亨	liao yuan de heng	1
林海股份	lin hai gu fen	1
林洋电子	lin yang dian zi	1
林州重机	lin zhou zhong ji	1
羚锐股份	ling rui gu fen	1
领先科技	ling xian ke ji	1
凌云股	ling yun gu	1
六国化工	liu guo hua gong	1
浏阳花炮	liu yang hua pao	1
龙涤	long di	1
龙涤股份	long di gu fen	1
龙电股份	long dian gu fen	1
龙发股份	long fa gu fen	1
龙力生物	long li sheng wu	1
龙盛转债	long sheng zhuan zhai	1
龙腾科技	long teng ke ji	1
龙头股份	long tou gu fen	1
龙溪股份	long xi gu fen	1
隆源双登	long yuan shuang deng	1
鲁北化工	lu bei hua gong	1
陆家股	lu jia gu	1
鲁抗医药	lu kang yi yao	1
鲁润	lu run	1
鲁润股份	lu run gu fen	1
鲁西化工	lu xi hua gong	1
鲁银投资	lu yin tou zi	1
轮胎橡胶	lun tai xiang jiao	1
罗顿发展	luo dun fa zhan	1
洛阳玻璃	luo yang bo li	1
氯碱股	lv jian gu	1
氯碱化工	lv jian hua gong	1
马钢股份	ma gang gu fen	1
马龙产业	ma long chan ye	1
茂化实华	mao hua shi hua	1
茂化永业	mao hua yong ye	1
美达股份	mei da gu fen	1
美的电器	mei di dian qi	1
美都控股	mei du kong gu	1
美丰发债	mei feng fa zhai	1
美利纸业	mei li zhi ye	1
美菱电器	mei ling dian qi	1
美罗药业	mei luo yao ye	1
美亚柏科	mei ya bai ke	1
美亚股份	mei ya gu fen	1
梅雁水电	mei yan shui dian	1
绵世股份	mian shi gu fen	1
闽灿坤	min can kun	1
闽东电力	min dong dian li	1
闽发铝业	min fa lv ye	1
民丰农化	min feng nong hua	1
民丰实业	min feng shi ye	1
岷江水电	min jiang shui dian	1
民族化工	min zu hua gong	1
民族集团	min zu ji tuan	1
明家科技	ming jia ke ji	1
名流置业	ming liu zhi ye	1
明牌珠宝	ming pai zhu bao	1
明星电力	ming xing dian li	1
摩恩电气	mo en dian qi	1
莫高股份	mo gao gu fen	1
摩根华鑫基础行业	mo gen hua xin ji chu hang ye	1
摩根华鑫资源优选	mo gen hua xin zi yuan you xuan	1
模塑科技	mo su ke ji	1
木材指数	mu cai zhi shu	1
纳川股份	na chuan gu fen	1
南玻科控	nan bo ke kong	1
南方宝元债券	nan fang bao yuan zhai quan	1
南方避险增值	nan fang bi xian zeng zhi	1
南方成份精选	nan fang cheng fen jing xuan	1
南方多利债券	nan fang duo li zhai quan	1
南方高增长	nan fang gao zeng zhang	1
南方恒元	nan fang heng yuan	1
南方汇通	nan fang hui tong	1
南方积极配置	nan fang ji ji pei zhi	1
南方绩优成长	nan fang ji you cheng zhang	1
南方建材	nan fang jian cai	1
南方控股	nan fang kong gu	1
南方隆元产业	nan fang long yuan chan ye	1
南方全球精选	nan fang quan qiu jing xuan	1
南方盛元红利	nan fang sheng yuan hong li	1
南方稳健成长	nan fang wen jian cheng zhang	1
南方稳健贰号	nan fang wen jian er hao	1
南方优选价值	nan fang you xuan jia zhi	1
南方轴承	nan fang zhou cheng	1
南风化工	nan feng hua gong	1
南钢股份	nan gang gu fen	1
南海发展	nan hai fa zhan	1
南华西	nan hua xi	1
南京高科	nan jing gao ke	1
南京化纤	nan jing hua xian	1
南京水运	nan jing shui yun	1
南京新百	nan jing xin bai	1
南京熊猫	nan jing xiong mao	1
南京医药	nan jing yi yao	1
南京中北	nan jing zhong bei	1
南京中达	nan jing zhong da	1
南开戈德	nan kai ge de	1
南摩	nan mo	1
南宁百货	nan ning bai huo	1
南宁糖业	nan ning tang ye	1
南山铝业	nan shan lv ye	1
南山实业	nan shan shi ye	1
南天信息	nan tian xin xi	1
内蒙华电	nei meng hua dian	1
内蒙君正	nei meng jun zheng	1
宁波东睦	ning bo dong mu	1
宁波富邦	ning bo fu bang	1
宁波富达	ning bo fu da	1
宁波海运	ning bo hai yun	1
宁波华联	ning bo hua lian	1
宁波华翔	ning bo hua xiang	1
宁波联合	ning bo lian he	1
宁波热电	ning bo re dian	1
宁城老窖	ning cheng lao jiao	1
宁沪高速	ning hu gao su	1
宁基股份	ning ji gu fen	1
农银成长	nong yin cheng zhang	1
农银增利	nong yin zeng li	1
诺安股票	nuo an gu piao	1
诺安价值增长	nuo an jia zhi zeng zhang	1
诺安灵活配置	nuo an ling huo pei zhi	1
诺安平衡	nuo an ping heng	1
诺安债券	nuo an zhai quan	1
诺德价值优势	nuo de jia zhi you shi	1
诺德灵活配置	nuo de ling huo pei zhi	1
欧亚集团	ou ya ji tuan	1
庞大集团	pang da ji tuan	1
鹏华动力增长	peng hua dong li zeng zhang	1
鹏华丰收债券	peng hua feng shou zhai quan	1
鹏华行业成长	peng hua hang ye cheng zhang	1
鹏华普天债券	peng hua pu tian zhai quan	1
鹏华盛世创新	peng hua sheng shi chuang xin	1
鹏华收益	peng hua shou yi	1
鹏华优质治理	peng hua you zhi zhi li	1
鹏华中国	peng hua zhong guo	1
平高电气	ping gao dian qi	1
浦东不锈	pu dong bu xiu	1
浦东建设	pu dong jian she	1
浦东金桥	pu dong jin qiao	1
普洛康裕	pu luo kang yu	1
浦银价值	pu yin jia zhi	1
旗滨集团	qi bin ji tuan	1
齐峰股份	qi feng gu fen	1
齐鲁石化	qi lu shi hua	1
七砂	qi sha	1
栖霞建设	qi xia jian she	1
启源装备	qi yuan zhuang bei	1
洽洽食品	qia qia shi pin	1
前锋股份	qian feng gu fen	1
千红制药	qian hong zhi yao	1
钱江摩托	qian jiang mo tuo	1
钱江水利	qian jiang shui li	1
潜江制药	qian jiang zhi yao	1
千金药业	qian jin yao ye	1
潜能恒信	qian neng heng xin	1
黔源电力	qian yuan dian li	1
强生控股	qiang sheng kong gu	1
秦川发展	qin chuan fa zhan	1
秦丰农业	qin feng nong ye	1
秦岭水泥	qin ling shui ni	1
青岛东方	qing dao dong fang	1
青岛海尔	qing dao hai er	1
青岛双星	qing dao shuang xing	1
轻工机械	qing gong ji xie	1
青海华鼎	qing hai hua ding	1
青海明胶	qing hai ming jiao	1
青海三普	qing hai san pu	1
青旅控股	qing lv kong gu	1
青鸟华光	qing niao hua guang	1
青鸟天桥	qing niao tian qiao	1
青啤债	qing pi zhai	1
青山纸业	qing shan zhi ye	1
青松股份	qing song gu fen	1
琼海德	qiong hai de	1
琼华侨	qiong hua qiao	1
琼能源	qiong neng yuan	1
秋林集团	qiu lin ji tuan	1
全柴动力	quan chai dong li	1
全兴股份	quan xing gu fen	1
群兴玩具	qun xing wan ju	1
燃控科技	ran kong ke ji	1
燃气股份	ran qi gu fen	1
日发数码	ri fa shu ma	1
荣华实业	rong hua shi ye	1
荣盛石化	rong sheng shi hua	1
融通动力先锋	rong tong dong li xian feng	1
融通行业	rong tong hang ye	1
融通巨潮	rong tong ju chao	1
融通蓝筹	rong tong lan chou	1
融通领先成长	rong tong ling xian cheng zhang	1
融通深证	rong tong shen zheng	1
融通新蓝筹	rong tong xin lan chou	1
融通债券	rong tong zhai quan	1
瑞丰高材	rui feng gao cai	1
瑞丰光电	rui feng guang dian	1
瑞凌股份	rui ling gu fen	1
瑞普生物	rui pu sheng wu	1
锐奇股份	rui qi gu fen	1
润邦股份	run bang gu fen	1
赛格三星	sai ge san xing	1
赛马实业	sai ma shi ye	1
三川股份	san chuan gu fen	1
三花股份	san hua gu fen	1
三环股份	san huan gu fen	1
三佳模具	san jia mu ju	1
三江购物	san jiang gou wu	1
三精制药	san jing zhi yao	1
三九生化	san jiu sheng hua	1
三九医药	san jiu yi yao	1
三毛股	san mao gu	1
三毛派神	san mao pai shen	1
三木集团	san mu ji tuan	1
三普药业	san pu yao ye	1
三峡水利	san xia shui li	1
三星石化	san xing shi hua	1
三友化工	san you hua gong	1
桑乐金	sang le jin	1
森马服饰	sen ma fu shi	1
森远股份	sen yuan gu fen	1
沙河股份	sha he gu fen	1
厦新	sha xin	1
陕长岭	shan chang ling	1
山川股份	shan chuan gu fen	1
山大华特	shan da hua te	1
山东高速	shan dong gao su	1
山东海龙	shan dong hai long	1
山东黑豹	shan dong hei bao	1
山东黄金	shan dong huang jin	1
山东基建	shan dong ji jian	1
山东金泰	shan dong jin tai	1
山东临工	shan dong lin gong	1
山东铝业	shan dong lv ye	1
山东墨龙	shan dong mo long	1
山东威达	shan dong wei da	1
山东药玻	shan dong yao bo	1
山东章鼓	shan dong zhang gu	1
陕解放	shan jie fang	1
杉杉股份	shan shan gu fen	1
山西汾酒	shan xi fen jiu	1
山西焦化	shan xi jiao hua	1
陕西金叶	shan xi jin ye	1
山西三维	shan xi san wei	1
山鹰纸业	shan ying zhi ye	1
上柴股	shang chai gu	1
上柴股份	shang chai gu fen	1
上电股	shang dian gu	1
上风高科	shang feng gao ke	1
上港集箱	shang gang ji xiang	1
上港债	shang gang zhai	1
上工股	shang gong gu	1
上工股份	shang gong gu fen	1
上海贝岭	shang hai bei ling	1
上海电力	shang hai dian li	1
上海辅仁	shang hai fu ren	1
上海港机	shang hai gang ji	1
上海航空	shang hai hang kong	1
上海机场	shang hai ji chang	1
上海机电	shang hai ji dian	1
上海家化	shang hai jia hua	1
上海建工	shang hai jian gong	1
上海金陵	shang hai jin ling	1
上海九百	shang hai jiu bai	1
上海科技	shang hai ke ji	1
上海绿新	shang hai lv xin	1
上海梅林	shang hai mei lin	1
上海能源	shang hai neng yuan	1
上海普天	shang hai pu tian	1
上海汽车	shang hai qi che	1
上海三毛	shang hai san mao	1
上海石化	shang hai shi hua	1
上海新梅	shang hai xin mei	1
上海医药	shang hai yi yao	1
上海永久	shang hai yong jiu	1
上菱电器	shang ling dian qi	1
尚荣医疗	shang rong yi liao	1
上实发展	shang shi fa zhan	1
上石化	shang shi hua	1
上实联合	shang shi lian he	1
上投成长	shang tou cheng zhang	1
上投内需动力	shang tou nei xu dong li	1
上投双核平衡	shang tou shuang he ping heng	1
上投双息平衡	shang tou shuang xi ping heng	1
上投亚太优势	shang tou ya tai you shi	1
上投中国优势	shang tou zhong guo you shi	1
商业网点	shang ye wang dian	1
深大通	shen da tong	1
深纺织	shen fang zhi	1
深华发	shen hua fa	1
深华新	shen hua xin	1
深华源	shen hua yuan	1
神火股份	shen huo gu fen	1
深机转债	shen ji zhuan zhai	1
深科技	shen ke ji	1
神龙发展	shen long fa zhan	1
神马实业	shen ma shi ye	1
神农大丰	shen nong da feng	1
深赛格	shen sai ge	1
申通地铁	shen tong di tie	1
申万巴黎添益宝	shen wan ba li tian yi bao	1
申万竞争优势	shen wan jing zheng you shi	1
深万山	shen wan shan	1
申万盛利精选	shen wan sheng li jing xuan	1
申万盛利强化	shen wan sheng li qiang hua	1
申万新动力	shen wan xin dong li	1
申万新经济	shen wan xin jing ji	1
沈新开	shen xin kai	1
沈阳化工	shen yang hua gong	1
沈阳机床	shen yang ji chuang	1
沈阳新开	shen yang xin kai	1
深圳华强	shen zhen hua qiang	1
深圳机场	shen zhen ji chang	1
神州股份	shen zhou gu fen	1
圣方科	sheng fang ke	1
省广股份	sheng guang gu fen	1
胜景山河	sheng jing shan he	1
胜利股份	sheng li gu fen	1
盛路通信	sheng lu tong xin	1
盛通股份	sheng tong gu fen	1
生益科技	sheng yi ke ji	1
盛运股份	sheng yun gu fen	1
实达电脑	shi da dian nao	1
时代科技	shi dai ke ji	1
石化发债	shi hua fa zhai	1
世纪光华	shi ji guang hua	1
世纪华通	shi ji hua tong	1
世纪星源	shi ji xing yuan	1
世纪游轮	shi ji you lun	1
世纪中天	shi ji zhong tian	1
石炼	shi lian	1
石炼化	shi lian hua	1
世茂股份	shi mao gu fen	1
仕奇实业	shi qi shi ye	1
石狮新发	shi shi xin fa	1
石岘纸业	shi xian zhi ye	1
石油大明	shi you da ming	1
石油龙昌	shi you long chang	1
首创股份	shou chuang gu fen	1
首旅股份	shou lv gu fen	1
曙光股份	shu guang gu fen	1
舒卡股份	shu ka gu fen	1
数码测绘	shu ma ce hui	1
数码网络	shu ma wang luo	1
舒泰神	shu tai shen	1
数源科技	shu yuan ke ji	1
双鹤药业	shuang he yao ye	1
双环传动	shuang huan chuan dong	1
双环科技	shuang huan ke ji	1
双汇发展	shuang hui fa zhan	1
双良股份	shuang liang gu fen	1
双林股份	shuang lin gu fen	1
双龙股份	shuang long gu fen	1
双鹭药业	shuang lu yao ye	1
双钱股	shuang qian gu	1
双塔食品	shuang ta shi pin	1
顺荣股份	shun rong gu fen	1
舜天船舶	shun tian chuan bo	1
顺鑫农业	shun xin nong ye	1
丝绸股份	si chou gu fen	1
四川长虹	si chuan chang hong	1
四川湖山	si chuan hu shan	1
四川金顶	si chuan jin ding	1
四川路桥	si chuan lu qiao	1
四川美丰	si chuan mei feng	1
四川双马	si chuan shuang ma	1
四创电子	si chuang dian zi	1
思达高科	si da gao ke	1
四方达	si fang da	1
四方股份	si fang gu fen	1
四环生物	si huan sheng wu	1
四环药业	si huan yao ye	1
四砂股份	si sha gu fen	1
四通高科	si tong gao ke	1
思源电气	si yuan dian qi	1
宋城股份	song cheng gu fen	1
松德股份	song de gu fen	1
松芝股份	song zhi gu fen	1
苏宁电器	su ning dian qi	1
苏宁环球	su ning huan qiu	1
隧道股份	sui dao gu fen	1
塔牌发债	ta pai fa zhai	1
泰达股份	tai da gu fen	1
泰达荷银成长	tai da he yin cheng zhang	1
泰达荷银集利	tai da he yin ji li	1
泰达荷银精选	tai da he yin jing xuan	1
泰达荷银首选	tai da he yin shou xuan	1
泰达荷银稳定	tai da he yin wen ding	1
泰达荷银效率	tai da he yin xiao lv	1
泰达荷银预算	tai da he yin yu suan	1
泰达荷银周期	tai da he yin zhou qi	1
泰达市值优选	tai da shi zhi you xuan	1
泰达债	tai da zhai	1
太光电信	tai guang dian xin	1
泰豪科技	tai hao ke ji	1
太极集团	tai ji ji tuan	1
太极实业	tai ji shi ye	1
泰山石油	tai shan shi you	1
泰胜风能	tai sheng feng neng	1
太太药业	tai tai yao ye	1
泰信双息双利	tai xin shuang xi shuang li	1
泰信先行策略	tai xin xian xing ce lue	1
泰信优势增长	tai xin you shi zeng zhang	1
泰信优质生活	tai xin you zhi sheng huo	1
泰亚股份	tai ya gu fen	1
太原刚玉	tai yuan gang yu	1
太原重工	tai yuan zhong gong	1
唐钢股份	tang gang gu fen	1
唐人神	tang ren shen	1
唐山陶瓷	tang shan tao ci	1
特发信息	te fa xin xi	1
特精股份	te jing gu fen	1
腾邦国际	teng bang guo ji	1
腾达建设	teng da jian she	1
天宸股份	tian chen gu fen	1
天创置业	tian chuang zhi ye	1
天地科技	tian di ke ji	1
天鹅股份	tian e gu fen	1
天发	tian fa	1
天发股份	tian fa gu fen	1
天房发展	tian fang fa zhan	1
天富热电	tian fu re dian	1
天歌科技	tian ge ke ji	1
天广消防	tian guang xiao fang	1
天鸿宝业	tian hong bao ye	1
天弘精选混合	tian hong jing xuan hun he	1
天弘永定价值	tian hong yong ding jia zhi	1
天弘永利债券	tian hong yong li zhai quan	1
天玑科技	tian ji ke ji	1
天津磁卡	tian jin ci ka	1
天津海运	tian jin hai yun	1
天津汽车	tian jin qi che	1
天科股份	tian ke gu fen	1
天利高新	tian li gao xin	1
天立环保	tian li huan bao	1
天伦置业	tian lun zhi ye	1
天马精化	tian ma jing hua	1
天目药业	tian mu yao ye	1
天奇股份	tian qi gu fen	1
天桥起重	tian qiao qi zhong	1
天瑞仪器	tian rui yi qi	1
天山纺织	tian shan fang zhi	1
天晟新材	tian sheng xin cai	1
天水股份	tian shui gu fen	1
天顺风能	tian shun feng neng	1
天坛生物	tian tan sheng wu	1
天通股份	tian tong gu fen	1
天香集团	tian xiang ji tuan	1
天药股份	tian yao gu fen	1
天一科	tian yi ke	1
天颐科技	tian yi ke ji	1
天一科技	tian yi ke ji	1
天音控股	tian yin kong gu	1
天喻信息	tian yu xin xi	1
天泽信息	tian ze xin xi	1
天治财富增长	tian zhi cai fu zeng zhang	1
天治创新先锋	tian zhi chuang xin xian feng	1
天治品质优选	tian zhi pin zhi you xuan	1
天治稳健双盈	tian zhi wen jian shuang ying	1
天舟文化	tian zhou wen hua	1
铁汉生态	tie han sheng tai	1
通宝能源	tong bao neng yuan	1
铜城集团	tong cheng ji tuan	1
通程控股	tong cheng kong gu	1
同达	tong da	1
通达动力	tong da dong li	1
通达股份	tong da gu fen	1
通鼎光电	tong ding guang dian	1
铜都铜业	tong du tong ye	1
同方股份	tong fang gu fen	1
通海高科	tong hai gao ke	1
通化东宝	tong hua dong bao	1
通化金马	tong hua jin ma	1
铜陵发债	tong ling fa zhai	1
通葡股份	tong pu gu fen	1
通葡萄酒	tong pu tao jiu	1
通威股份	tong wei gu fen	1
通裕重工	tong yu zhong gong	1
通源石油	tong yuan shi you	1
沱牌曲酒	tuo pai qu jiu	1
托普软件	tuo pu ruan jian	1
外高股	wai gao gu	1
外运发展	wai yun fa zhan	1
万达信息	wan da xin xi	1
万东医疗	wan dong yi liao	1
万和电气	wan he dian qi	1
万家公用	wan jia gong yong	1
万家和谐	wan jia he xie	1
万家双引擎	wan jia shuang yin qing	1
万家债券	wan jia zhai quan	1
万里电池	wan li dian chi	1
皖能电力	wan neng dian li	1
皖通高速	wan tong gao su	1
万通先锋	wan tong xian feng	1
皖维高新	wan wei gao xin	1
万向钱潮	wan xiang qian chao	1
万讯自控	wan xun zi kong	1
王府发债	wang fu fa zhai	1
网盛科技	wang sheng ke ji	1
潍柴动力	wei chai dong li	1
威尔科技	wei er ke ji	1
维尔利	wei er li	1
尾盘跳水	wei pan tiao shui	1
维维股份	wei wei gu fen	1
伟星股份	wei xing gu fen	1
威远生化	wei yuan sheng hua	1
文山电力	wen shan dian li	1
卧龙电气	wo long dian qi	1
卧龙科技	wo long ke ji	1
沃森生物	wo sen sheng wu	1
武钢股份	wu gang gu fen	1
武汉健民	wu han jian min	1
武汉控股	wu han kong gu	1
武汉石油	wu han shi you	1
武汉塑料	wu han su liao	1
武汉中百	wu han zhong bai	1
武汉中商	wu han zhong shang	1
乌江电力	wu jiang dian li	1
五矿发展	wu kuang fa zhan	1
物贸股	wu mao gu	1
物贸中心	wu mao zhong xin	1
吴忠仪表	wu zhong yi biao	1
五洲交通	wu zhou jiao tong	1
五洲明珠	wu zhou ming zhu	1
梧州中恒	wu zhou zhong heng	1
五洲转债	wu zhou zhuan zhai	1
西安旅游	xi an lv you	1
西安民生	xi an min sheng	1
西安饮食	xi an yin shi	1
西北化工	xi bei hua gong	1
西北轴承	xi bei zhou cheng	1
西泵股份	xi beng gu fen	1
西昌电力	xi chang dian li	1
西飞国际	xi fei guo ji	1
西化机	xi hua ji	1
西南合成	xi nan he cheng	1
西南药业	xi nan yao ye	1
西宁特钢	xi ning te gang	1
西山煤电	xi shan mei dian	1
西水股份	xi shui gu fen	1
稀土高科	xi tu gao ke	1
西洋转债	xi yang zhuan zhai	1
锡业转债	xi ye zhuan zhai	1
西藏发展	xi zang fa zhan	1
西藏金珠	xi zang jin zhu	1
西藏矿业	xi zang kuang ye	1
西藏明珠	xi zang ming zhu	1
西藏圣地	xi zang sheng di	1
西藏天路	xi zang tian lu	1
西藏药业	xi zang yao ye	1
厦华电子	xia hua dian zi	1
厦门港务	xia men gang wu	1
厦门国贸	xia men guo mao	1
厦门机场	xia men ji chang	1
厦门空港	xia men kong gang	1
厦门汽车	xia men qi che	1
厦门信达	xia men xin da	1
夏新电子	xia xin dian zi	1
贤成实业	xian cheng shi ye	1
现代投资	xian dai tou zi	1
现代制药	xian dai zhi yao	1
先锋股份	xian feng gu fen	1
先锋新材	xian feng xin cai	1
先河环保	xian he huan bao	1
咸阳偏转	xian yang pian zhuan	1
湘计算机	xiang ji suan ji	1
香江控股	xiang jiang kong gu	1
湘酒鬼	xiang jiu gui	1
襄阳轴承	xiang yang zhou cheng	1
湘邮科技	xiang you ke ji	1
襄轴	xiang zhou	1
小鸭电器	xiao ya dian qi	1
新安股份	xin an gu fen	1
新潮实业	xin chao shi ye	1
新城股	xin cheng gu	1
信诚精萃成长	xin cheng jing cui cheng zhang	1
信诚三得益	xin cheng san de yi	1
信诚盛世蓝筹	xin cheng sheng shi lan chou	1
信诚四季红	xin cheng si ji hong	1
信达澳银灵活配置	xin da ao yin ling huo pei zhi	1
信达澳银领先	xin da ao yin ling xian	1
新都化工	xin du hua gong	1
新都酒店	xin du jiu dian	1
鑫富药业	xin fu yao ye	1
新湖创业	xin hu chuang ye	1
新华百货	xin hua bai huo	1
新华传媒	xin hua chuan mei	1
新华股份	xin hua gu fen	1
新华光	xin hua guang	1
新华医疗	xin hua yi liao	1
新华制药	xin hua zhi yao	1
新黄浦	xin huang pu	1
新疆城建	xin jiang cheng jian	1
新疆天宏	xin jiang tian hong	1
新疆屯河	xin jiang tun he	1
新疆众和	xin jiang zhong he	1
新界泵业	xin jie beng ye	1
新锦江	xin jin jiang	1
新开普	xin kai pu	1
新力药业	xin li yao ye	1
新联电子	xin lian dian zi	1
信联股份	xin lian gu fen	1
欣龙无纺	xin long wu fang	1
新农开发	xin nong kai fa	1
新世纪成长	xin shi ji cheng zhang	1
新世纪混合	xin shi ji hun he	1
新太	xin tai	1
新太科技	xin tai ke ji	1
新天国际	xin tian guo ji	1
欣旺达	xin wang da	1
信维通信	xin wei tong xin	1
新五丰	xin wu feng	1
新希望	xin xi wang	1
新乡化纤	xin xiang hua xian	1
鑫新股份	xin xin gu fen	1
新兴铸管	xin xing zhu guan	1
新亚股份	xin ya gu fen	1
新研股份	xin yan gu fen	1
新宇软件	xin yu ruan jian	1
新筑股份	xin zhu gu fen	1
兴发集团	xing fa ji tuan	1
星河生物	xing he sheng wu	1
星湖科技	xing hu ke ji	1
邢台轧辊	xing tai zha gun	1
兴业聚酯	xing ye ju zhi	1
兴业可转债	xing ye ke zhuan zhai	1
兴业全球视野	xing ye quan qiu shi ye	1
兴业社会责任	xing ye she hui ze ren	1
星宇股份	xing yu gu fen	1
兄弟科技	xiong di ke ji	1
雄震集团	xiong zhen ji tuan	1
秀强股份	xiu qiang gu fen	1
旭飞实业	xu fei shi ye	1
徐工科技	xu gong ke ji	1
旭光股份	xu guang gu fen	1
许继电气	xu ji dian qi	1
徐家汇	xu jia hui	1
雪绒	xue rong	1
雅化集团	ya hua ji tuan	1
亚华种业	ya hua zhong ye	1
亚泰集团	ya tai ji tuan	1
亚太科技	ya tai ke ji	1
亚通股份	ya tong gu fen	1
亚威股份	ya wei gu fen	1
亚夏汽车	ya xia qi che	1
亚星化学	ya xing hua xue	1
亚星锚链	ya xing mao lian	1
延边公路	yan bian gong lu	1
盐湖钾肥	yan hu jia fei	1
燕化高新	yan hua gao xin	1
燕京发债	yan jing fa zhai	1
燕京啤酒	yan jing pi jiu	1
烟台发展	yan tai fa zhan	1
兖州煤业	yan zhou mei ye	1
阳晨	yang chen	1
阳晨股	yang chen gu	1
阳谷华泰	yang gu hua tai	1
阳光发展	yang guang fa zhan	1
阳光股份	yang guang gu fen	1
扬农化工	yang nong hua gong	1
扬子石化	yang zi shi hua	1
耀华玻璃	yao hua bo li	1
姚记扑克	yao ji pu ke	1
耀皮	yao pi	1
耀皮玻璃	yao pi bo li	1
耀皮股	yao pi gu	1
宜宾纸业	yi bin zhi ye	1
亿城股份	yi cheng gu fen	1
易方达科汇	yi fang da ke hui	1
易方达科翔	yi fang da ke xiang	1
易方达中小盘	yi fang da zhong xiao pan	1
仪化	yi hua	1
易基策略成长	yi ji ce lue cheng zhang	1
易基策略二号	yi ji ce lue er hao	1
易基积极成长	yi ji ji ji cheng zhang	1
易基价值成长	yi ji jia zhi cheng zhang	1
易基价值精选	yi ji jia zhi jing xuan	1
易基科讯	yi ji ke xun	1
易基深	yi ji shen	1
易基稳健收益	yi ji wen jian shou yi	1
易基增强债券	yi ji zeng qiang zhai quan	1
易基指数	yi ji zhi shu	1
宜科科技	yi ke ke ji	1
伊利股份	yi li gu fen	1
亿利科技	yi li ke ji	1
易联众	yi lian zhong	1
以岭药业	yi ling yao ye	1
依米康	yi mi kang	1
益民百货	yi min bai huo	1
益民创新优势	yi min chuang xin you shi	1
益民多利	yi min duo li	1
益民红利成长	yi min hong li cheng zhang	1
一汽轿车	yi qi jiao che	1
一汽四环	yi qi si huan	1
一汽夏利	yi qi xia li	1
益盛药业	yi sheng yao ye	1
伊泰股	yi tai gu	1
仪征化纤	yi zheng hua xian	1
一致药业	yi zhi yao ye	1
银河创新	yin he chuang xin	1
银河动力	yin he dong li	1
银河竞争优势	yin he jing zheng you shi	1
银河科技	yin he ke ji	1
银河收益	yin he shou yi	1
银河稳健	yin he wen jian	1
银河银泰理财	yin he yin tai li cai	1
银河银信添利	yin he yin xin tian li	1
银华保本增值	yin hua bao ben zeng zhi	1
银华道琼斯	yin hua dao qiong si	1
银华富裕	yin hua fu yu	1
银华领先策略	yin hua ling xian ce lue	1
银华全球核心	yin hua quan qiu he xin	1
银华优势企业	yin hua you shi qi ye	1
银华优选股票	yin hua you xuan gu piao	1
银华优质增长	yin hua you zhi zeng zhang	1
银华增强收益	yin hua zeng qiang shou yi	1
银泰股份	yin tai gu fen	1
银座股份	yin zuo gu fen	1
英豪科教	ying hao ke jiao	1
英唐智控	ying tang zhi kong	1
英特集团	ying te ji tuan	1
英雄股份	ying xiong gu fen	1
永安林业	yong an lin ye	1
永鼎光缆	yong ding guang lan	1
甬华通	yong hua tong	1
永久股	yong jiu gu	1
永清环保	yong qing huan bao	1
永生股	yong sheng gu	1
永生数据	yong sheng shu ju	1
永新股份	yong xin gu fen	1
用友软件	yong you ruan jian	1
友邦成长	you bang cheng zhang	1
友邦红利	you bang hong li	1
友邦价值增长	you bang jia zhi zeng zhang	1
友邦盛世	you bang sheng shi	1
友邦增利	you bang zeng li	1
友好集团	you hao ji tuan	1
友谊股	you yi gu	1
友谊股份	you yi gu fen	1
豫光金铅	yu guang jin qian	1
渝钛白	yu tai bai	1
宇通客车	yu tong ke che	1
园城股份	yuan cheng gu fen	1
远东股份	yuan dong gu fen	1
元力股份	yuan li gu fen	1
原水股份	yuan shui gu fen	1
原宜	yuan yi	1
粤电债	yue dian zhai	1
粤高速	yue gao su	1
粤华电	yue hua dian	1
粤美的	yue mei di	1
粤美雅	yue mei ya	1
岳阳恒立	yue yang heng li	1
岳阳纸业	yue yang zhi ye	1
云铝股份	yun lv gu fen	1
云南铜业	yun nan tong ye	1
运盛实业	yun sheng shi ye	1
藏药业	zang yao ye	1
长高集团	zhang gao ji tuan	1
张化机	zhang hua ji	1
张江高科	zhang jiang gao ke	1
漳泽电力	zhang ze dian li	1
漳州发展	zhang zhou fa zhan	1
朝华科技	zhao hua ke ji	1
招商安本增利	zhao shang an ben zeng li	1
招商安泰股票	zhao shang an tai gu piao	1
招商安泰平衡	zhao shang an tai ping heng	1
招商安心收益	zhao shang an xin shou yi	1
招商成长	zhao shang cheng zhang	1
招商大盘蓝筹	zhao shang da pan lan chou	1
招商地产	zhao shang di chan	1
招商价值	zhao shang jia zhi	1
招商先锋	zhao shang xian feng	1
招商债券	zhao shang zhai quan	1
浙大海纳	zhe da hai na	1
浙江创业	zhe jiang chuang ye	1
浙江东日	zhe jiang dong ri	1
浙江富润	zhe jiang fu run	1
浙江海亮	zhe jiang hai liang	1
浙江阳光	zhe jiang yang guang	1
浙江医药	zhe jiang yi yao	1
浙江永强	zhe jiang yong qiang	1
浙江众成	zhe jiang zhong cheng	1
振东制药	zhen dong zhi yao	1
振华港	zhen hua gang	1
振华股	zhen hua gu	1
振华科技	zhen hua ke ji	1
郑州煤电	zheng zhou mei dian	1
置信电气	zhi xin dian qi	1
智云股份	zhi yun gu fen	1
中材国际	zhong cai guo ji	1
中川国际	zhong chuan guo ji	1
中达股份	zhong da gu fen	1
中大股份	zhong da gu fen	1
中电环保	zhong dian huan bao	1
中鼎发债	zhong ding fa zhai	1
中发展	zhong fa zhan	1
中纺机	zhong fang ji	1
中纺投资	zhong fang tou zi	1
中国玻纤	zhong guo bo xian	1
中国泛旅	zhong guo fan lv	1
中国凤凰	zhong guo feng huang	1
中国服装	zhong guo fu zhuang	1
中国高科	zhong guo gao ke	1
中国国贸	zhong guo guo mao	1
中国化建	zhong guo hua jian	1
中国嘉陵	zhong guo jia ling	1
中国软件	zhong guo ruan jian	1
中国石化	zhong guo shi hua	1
中国卫星	zhong guo wei xing	1
中国武夷	zhong guo wu yi	1
中国重汽	zhong guo zhong qi	1
中海达	zhong hai da	1
中海发展	zhong hai fa zhan	1
中海分红混合	zhong hai fen hong hun he	1
中海蓝筹灵活	zhong hai lan chou ling huo	1
中海能源策略	zhong hai neng yuan ce lue	1
中海稳健债券	zhong hai wen jian zhai quan	1
中海优质成长	zhong hai you zhi cheng zhang	1
中行发债	zhong hang fa zhai	1
中恒集团	zhong heng ji tuan	1
中化国际	zhong hua guo ji	1
中华企业	zhong hua qi ye	1
中化岩土	zhong hua yan tu	1
中集集团	zhong ji ji tuan	1
中江地产	zhong jiang di chan	1
中金黄金	zhong jin huang jin	1
中金岭南	zhong jin ling nan	1
中炬高新	zhong ju gao xin	1
中科健	zhong ke jian	1
中科三环	zhong ke san huan	1
中粮屯河	zhong liang tun he	1
中牧股份	zhong mu gu fen	1
中南重工	zhong nan zhong gong	1
中农资源	zhong nong zi yuan	1
中欧新蓝筹	zhong ou xin lan chou	1
中欧新趋势	zhong ou xin qu shi	1
中铅	zhong qian	1
中铅股	zhong qian gu	1
中色股份	zhong se gu fen	1
中色建设	zhong se jian she	1
中商股份	zhong shang gu fen	1
重实	zhong shi	1
中视传媒	zhong shi chuan mei	1
中水渔业	zhong shui yu ye	1
中天科技	zhong tian ke ji	1
中通客车	zhong tong ke che	1
中钨高新	zhong wu gao xin	1
中西药业	zhong xi yao ye	1
中信国安	zhong xin guo an	1
中信红利精选	zhong xin hong li jing xuan	1
中信经典配置	zhong xin jing dian pei zhi	1
中信稳定双利	zhong xin wen ding shuang li	1
中新药业	zhong xin yao ye	1
中信证券	zhong xin zheng quan	1
中兴商业	zhong xing shang ye	1
中兴通讯	zhong xing tong xun	1
中讯科技	zhong xun ke ji	1
中燕	zhong yan	1
中银策略	zhong yin ce lue	1
中银收益	zhong yin shou yi	1
中银增利	zhong yin zeng li	1
中银增长	zhong yin zeng zhang	1
中银中国	zhong yin zhong guo	1
中邮核心成长	zhong you he xin cheng zhang	1
中邮核心优选	zhong you he xin you xuan	1
中远发展	zhong yuan fa zhan	1
中原高速	zhong yuan gao su	1
中远航运	zhong yuan hang yun	1
中原环保	zhong yuan huan bao	1
中原内配	zhong yuan nei pei	1
中原油气	zhong yuan you qi	1
中远债	zhong yuan zhai	1
珠峰摩托	zhu feng mo tuo	1
珠海中富	zhu hai zhong fu	1
珠江控股	zhu jiang kong gu	1
珠江实业	zhu jiang shi ye	1
竹林众生	zhu lin zhong sheng	1
株冶火炬	zhu ye huo ju	1
紫光股份	zi guang gu fen	1
自仪	zi yi	1
自仪股	zi yi gu	1
纵横国际	zong heng guo ji	1
宗申动力	zong shen dong li	1
佐力药业	zuo li yao ye	1
